"","State","Year","Undergrad","Professional","Grad","Total"
"1","Alabama",2017,20,14,2,36
"2","Alabama",2016,17,15,2,34
"3","Alabama",2015,15,15,1,31
"4","Alabama",2014,10,17,0,27
"5","Alabama",2013,7,11,1,19
"6","Alabama",2012,9,10,1,20
"7","Alabama",2011,15,10,2,27
"8","Alabama",2010,13,7,2,22
"9","Alabama",2009,13,7,2,22
"10","Alabama",2008,12,8,2,22
"11","Alabama",2007,11,9,3,23
"12","Alabama",2006,11,9,1,21
"13","Alabama",2005,16,5,0,21
"14","Alabama",2004,16,8,0,24
"15","Alabama",2003,23,26,0,49
"16","Alabama",2002,22,23,0,45
"17","Alabama",2001,21,20,0,41
"18","Alabama",2000,20,21,1,42
"19","Alabama",1999,19,21,2,42
"20","Alabama",1998,13,18,2,33
"21","Alabama",1997,14,1,22,37
"22","Alabama",1996,14,0,24,38
"23","Alabama",1995,12,0,20,32
"24","Alabama",1994,8,0,12,20
"25","Alabama",1993,10,0,10,20
"26","Alabama",1992,13,0,10,23
"27","Alabama",1991,11,1,10,22
"28","Alabama",1990,11,1,14,26
"29","Alabama",1989,7,1,9,17
"30","Alabama",1988,8,0,13,21
"31","Alabama",1987,13,0,12,25
"32","Alabama",1986,10,0,15,25
"33","Alabama",1985,5,0,12,17
"34","Alabama",1984,8,0,11,19
"35","Alabama",1983,7,0,10,17
"36","Alabama",1982,6,0,13,19
"37","Alabama",1981,6,1,15,22
"38","Alabama",1980,3,0,13,16
"39","Alabama",1979,1,0,12,13
"40","Alabama",1978,2,0,10,12
"41","Alabama",1977,3,0,20,23
"42","Alabama",1976,4,0,16,20
"43","Alabama",1975,3,1,17,21
"44","Alaska",2017,5,6,0,11
"45","Alaska",2016,3,4,0,7
"46","Alaska",2015,2,5,0,7
"47","Alaska",2014,3,7,0,10
"48","Alaska",2013,3,3,0,6
"49","Alaska",2012,5,4,0,9
"50","Alaska",2011,6,4,0,10
"51","Alaska",2010,6,5,1,12
"52","Alaska",2009,6,5,1,12
"53","Alaska",2008,3,4,2,9
"54","Alaska",2007,2,4,0,6
"55","Alaska",2006,3,4,1,8
"56","Alaska",2005,5,3,1,9
"57","Alaska",2004,4,1,1,6
"58","Alaska",2003,5,8,1,14
"59","Alaska",2002,5,5,0,10
"60","Alaska",2001,5,11,0,16
"61","Alaska",2000,5,11,0,16
"62","Alaska",1999,5,14,0,19
"63","Alaska",1998,5,7,0,12
"64","Alaska",1997,6,0,8,14
"65","Alaska",1996,5,0,10,15
"66","Alaska",1995,6,0,15,21
"67","Alaska",1994,3,0,7,10
"68","Alaska",1993,1,0,4,5
"69","Alaska",1992,2,0,3,5
"70","Alaska",1991,3,0,3,6
"71","Alaska",1990,5,0,3,8
"72","Alaska",1989,5,0,3,8
"73","Alaska",1988,2,0,4,6
"74","Alaska",1987,0,0,0,0
"75","Alaska",1986,0,0,0,0
"76","Alaska",1985,0,0,NA,0
"77","Alaska",1984,0,0,0,0
"78","Alaska",1983,0,0,3,3
"79","Alaska",1982,1,0,3,4
"80","Alaska",1981,0,0,2,2
"81","Alaska",1980,0,0,2,2
"82","Alaska",1979,0,0,1,1
"83","Alaska",1978,0,0,2,2
"84","Alaska",1977,1,0,1,2
"85","Alaska",1976,1,0,2,3
"86","Alaska",1975,0,0,2,2
"87","Arizona",2017,39,59,7,105
"88","Arizona",2016,34,31,5,70
"89","Arizona",2015,37,26,3,66
"90","Arizona",2014,28,21,3,52
"91","Arizona",2013,18,22,3,43
"92","Arizona",2012,22,17,3,42
"93","Arizona",2011,15,17,2,34
"94","Arizona",2010,20,16,4,40
"95","Arizona",2009,20,16,4,40
"96","Arizona",2008,19,7,6,32
"97","Arizona",2007,17,8,4,29
"98","Arizona",2006,25,9,6,40
"99","Arizona",2005,26,13,4,43
"100","Arizona",2004,22,16,2,40
"101","Arizona",2003,24,35,1,60
"102","Arizona",2002,22,27,3,52
"103","Arizona",2001,21,26,3,50
"104","Arizona",2000,14,26,1,41
"105","Arizona",1999,12,23,4,39
"106","Arizona",1998,11,20,4,35
"107","Arizona",1997,10,4,18,32
"108","Arizona",1996,14,3,18,35
"109","Arizona",1995,17,1,24,42
"110","Arizona",1994,17,1,14,32
"111","Arizona",1993,13,1,15,29
"112","Arizona",1992,10,0,19,29
"113","Arizona",1991,8,0,14,22
"114","Arizona",1990,11,0,10,21
"115","Arizona",1989,9,1,11,21
"116","Arizona",1988,13,0,9,22
"117","Arizona",1987,12,0,9,21
"118","Arizona",1986,6,0,14,20
"119","Arizona",1985,4,0,11,15
"120","Arizona",1984,4,0,11,15
"121","Arizona",1983,3,0,8,11
"122","Arizona",1982,4,0,8,12
"123","Arizona",1981,4,0,8,12
"124","Arizona",1980,4,0,7,11
"125","Arizona",1979,3,0,10,13
"126","Arizona",1978,4,0,13,17
"127","Arizona",1977,3,1,18,22
"128","Arizona",1976,1,1,16,18
"129","Arizona",1975,3,0,10,13
"130","Arkansas",2017,6,14,2,22
"131","Arkansas",2016,10,13,1,24
"132","Arkansas",2015,9,12,1,22
"133","Arkansas",2014,10,8,1,19
"134","Arkansas",2013,12,10,2,24
"135","Arkansas",2012,10,12,2,24
"136","Arkansas",2011,10,9,2,21
"137","Arkansas",2010,8,6,2,16
"138","Arkansas",2009,8,6,2,16
"139","Arkansas",2008,3,10,2,15
"140","Arkansas",2007,8,12,2,22
"141","Arkansas",2006,9,11,0,20
"142","Arkansas",2005,13,10,0,23
"143","Arkansas",2004,17,6,0,23
"144","Arkansas",2003,14,20,0,34
"145","Arkansas",2002,11,16,1,28
"146","Arkansas",2001,8,16,1,25
"147","Arkansas",2000,11,19,3,33
"148","Arkansas",1999,14,23,2,39
"149","Arkansas",1998,14,18,2,34
"150","Arkansas",1997,15,2,14,31
"151","Arkansas",1996,10,0,11,21
"152","Arkansas",1995,6,0,12,18
"153","Arkansas",1994,4,0,NA,4
"154","Arkansas",1993,5,1,7,13
"155","Arkansas",1992,5,2,9,16
"156","Arkansas",1991,4,3,6,13
"157","Arkansas",1990,8,0,6,14
"158","Arkansas",1989,5,1,6,12
"159","Arkansas",1988,6,0,4,10
"160","Arkansas",1987,5,1,10,16
"161","Arkansas",1986,5,1,6,12
"162","Arkansas",1985,4,0,11,15
"163","Arkansas",1984,4,0,11,15
"164","Arkansas",1983,6,0,8,14
"165","Arkansas",1982,7,0,5,12
"166","Arkansas",1981,3,0,4,7
"167","Arkansas",1980,5,0,4,9
"168","Arkansas",1979,8,0,5,13
"169","Arkansas",1978,6,0,5,11
"170","Arkansas",1977,6,0,11,17
"171","Arkansas",1976,4,0,9,13
"172","Arkansas",1975,5,1,5,11
"173","California",2017,1011,425,43,1479
"174","California",2016,937,226,42,1205
"175","California",2015,828,232,38,1098
"176","California",2014,643,204,37,884
"177","California",2013,490,169,33,692
"178","California",2012,366,172,40,578
"179","California",2011,262,161,43,466
"180","California",2010,187,161,48,396
"181","California",2009,187,161,48,396
"182","California",2008,145,136,25,306
"183","California",2007,152,121,22,295
"184","California",2006,158,122,21,301
"185","California",2005,159,112,27,298
"186","California",2004,179,83,32,294
"187","California",2003,176,251,35,462
"188","California",2002,155,221,34,410
"189","California",2001,146,223,28,397
"190","California",2000,121,233,28,382
"191","California",1999,102,215,28,345
"192","California",1998,108,211,26,345
"193","California",1997,113,27,206,346
"194","California",1996,116,28,168,312
"195","California",1995,102,14,133,249
"196","California",1994,82,14,108,204
"197","California",1993,89,14,114,217
"198","California",1992,69,16,106,191
"199","California",1991,66,4,101,171
"200","California",1990,81,4,79,164
"201","California",1989,63,6,77,146
"202","California",1988,79,3,84,166
"203","California",1987,65,1,112,178
"204","California",1986,60,0,100,160
"205","California",1985,62,0,115,177
"206","California",1984,64,0,107,171
"207","California",1983,41,1,113,155
"208","California",1982,50,1,90,141
"209","California",1981,39,1,81,121
"210","California",1980,2,0,101,103
"211","California",1979,12,1,79,92
"212","California",1978,16,2,87,105
"213","California",1977,14,0,104,118
"214","California",1976,18,2,89,109
"215","California",1975,18,2,97,117
"216","Colorado",2017,47,67,5,119
"217","Colorado",2016,52,33,3,88
"218","Colorado",2015,52,33,0,85
"219","Colorado",2014,51,27,2,80
"220","Colorado",2013,47,16,6,69
"221","Colorado",2012,41,16,6,63
"222","Colorado",2011,28,15,10,53
"223","Colorado",2010,23,20,6,49
"224","Colorado",2009,23,20,6,49
"225","Colorado",2008,20,15,4,39
"226","Colorado",2007,20,14,1,35
"227","Colorado",2006,27,15,1,43
"228","Colorado",2005,30,17,2,49
"229","Colorado",2004,30,12,3,45
"230","Colorado",2003,35,36,8,79
"231","Colorado",2002,39,42,7,88
"232","Colorado",2001,30,42,7,79
"233","Colorado",2000,31,45,5,81
"234","Colorado",1999,33,46,3,82
"235","Colorado",1998,26,41,2,69
"236","Colorado",1997,33,1,37,71
"237","Colorado",1996,31,2,30,63
"238","Colorado",1995,33,0,25,58
"239","Colorado",1994,34,0,22,56
"240","Colorado",1993,32,0,24,56
"241","Colorado",1992,28,0,26,54
"242","Colorado",1991,27,0,21,48
"243","Colorado",1990,22,0,17,39
"244","Colorado",1989,9,0,21,30
"245","Colorado",1988,14,1,20,35
"246","Colorado",1987,15,0,29,44
"247","Colorado",1986,11,1,23,35
"248","Colorado",1985,11,1,18,30
"249","Colorado",1984,10,0,31,41
"250","Colorado",1983,10,1,21,32
"251","Colorado",1982,10,1,16,27
"252","Colorado",1981,13,0,12,25
"253","Colorado",1980,7,1,1,9
"254","Colorado",1979,8,0,16,24
"255","Colorado",1978,2,0,10,12
"256","Colorado",1977,5,0,12,17
"257","Colorado",1976,4,0,14,18
"258","Colorado",1975,3,2,21,26
"259","Connecticut",2017,40,39,6,85
"260","Connecticut",2016,43,21,4,68
"261","Connecticut",2015,40,22,3,65
"262","Connecticut",2014,34,19,3,56
"263","Connecticut",2013,39,20,4,63
"264","Connecticut",2012,31,17,4,52
"265","Connecticut",2011,35,24,5,64
"266","Connecticut",2010,32,21,3,56
"267","Connecticut",2009,32,21,3,56
"268","Connecticut",2008,28,17,4,49
"269","Connecticut",2007,21,13,3,37
"270","Connecticut",2006,22,13,4,39
"271","Connecticut",2005,24,12,3,39
"272","Connecticut",2004,18,9,4,31
"273","Connecticut",2003,34,34,7,75
"274","Connecticut",2002,32,26,7,65
"275","Connecticut",2001,29,21,6,56
"276","Connecticut",2000,35,24,6,65
"277","Connecticut",1999,27,24,3,54
"278","Connecticut",1998,30,25,3,58
"279","Connecticut",1997,32,2,29,63
"280","Connecticut",1996,30,1,29,60
"281","Connecticut",1995,33,0,24,57
"282","Connecticut",1994,27,0,16,43
"283","Connecticut",1993,32,1,20,53
"284","Connecticut",1992,29,1,20,50
"285","Connecticut",1991,29,3,19,51
"286","Connecticut",1990,33,2,14,49
"287","Connecticut",1989,31,2,13,46
"288","Connecticut",1988,28,1,6,35
"289","Connecticut",1987,25,3,9,37
"290","Connecticut",1986,19,3,18,40
"291","Connecticut",1985,15,2,22,39
"292","Connecticut",1984,11,1,23,35
"293","Connecticut",1983,9,2,23,34
"294","Connecticut",1982,10,0,31,41
"295","Connecticut",1981,15,1,28,44
"296","Connecticut",1980,18,2,29,49
"297","Connecticut",1979,19,1,23,43
"298","Connecticut",1978,20,1,20,41
"299","Connecticut",1977,21,3,31,55
"300","Connecticut",1976,12,1,34,47
"301","Connecticut",1975,8,1,38,47
"302","Delaware",2017,5,3,0,8
"303","Delaware",2016,6,3,0,9
"304","Delaware",2015,4,4,0,8
"305","Delaware",2014,7,5,0,12
"306","Delaware",2013,6,5,0,11
"307","Delaware",2012,6,7,0,13
"308","Delaware",2011,2,5,1,8
"309","Delaware",2010,1,6,1,8
"310","Delaware",2009,1,6,1,8
"311","Delaware",2008,5,5,0,10
"312","Delaware",2007,7,5,0,12
"313","Delaware",2006,5,4,0,9
"314","Delaware",2005,4,2,0,6
"315","Delaware",2004,4,2,0,6
"316","Delaware",2003,2,3,0,5
"317","Delaware",2002,4,5,1,10
"318","Delaware",2001,4,6,1,11
"319","Delaware",2000,5,5,1,11
"320","Delaware",1999,4,8,0,12
"321","Delaware",1998,4,7,0,11
"322","Delaware",1997,3,0,7,10
"323","Delaware",1996,7,0,9,16
"324","Delaware",1995,8,0,9,17
"325","Delaware",1994,7,0,4,11
"326","Delaware",1993,9,1,2,12
"327","Delaware",1992,3,2,5,10
"328","Delaware",1991,5,1,7,13
"329","Delaware",1990,6,0,3,9
"330","Delaware",1989,6,0,3,9
"331","Delaware",1988,6,0,3,9
"332","Delaware",1987,3,0,0,3
"333","Delaware",1986,2,0,7,9
"334","Delaware",1985,2,0,6,8
"335","Delaware",1984,4,0,5,9
"336","Delaware",1983,4,0,5,9
"337","Delaware",1982,2,0,8,10
"338","Delaware",1981,2,0,7,9
"339","Delaware",1980,3,0,7,10
"340","Delaware",1979,3,0,6,9
"341","Delaware",1978,1,1,9,11
"342","Delaware",1977,3,2,8,13
"343","Delaware",1976,1,1,6,8
"344","Delaware",1975,1,2,7,10
"345","District of Columbia",2017,2,9,1,12
"346","District of Columbia",2016,4,3,2,9
"347","District of Columbia",2015,5,4,1,10
"348","District of Columbia",2014,5,4,1,10
"349","District of Columbia",2013,2,4,1,7
"350","District of Columbia",2012,3,5,0,8
"351","District of Columbia",2011,5,4,0,9
"352","District of Columbia",2010,10,6,0,16
"353","District of Columbia",2009,10,6,0,16
"354","District of Columbia",2008,12,6,0,18
"355","District of Columbia",2007,8,6,0,14
"356","District of Columbia",2006,7,1,1,9
"357","District of Columbia",2005,2,1,0,3
"358","District of Columbia",2004,2,5,1,8
"359","District of Columbia",2003,3,7,0,10
"360","District of Columbia",2002,2,8,1,11
"361","District of Columbia",2001,2,9,2,13
"362","District of Columbia",2000,3,13,2,18
"363","District of Columbia",1999,2,8,2,12
"364","District of Columbia",1998,2,7,1,10
"365","District of Columbia",1997,4,6,1,11
"366","District of Columbia",1996,2,3,0,5
"367","District of Columbia",1995,5,3,0,8
"368","District of Columbia",1994,4,2,0,6
"369","District of Columbia",1993,2,4,0,6
"370","District of Columbia",1992,1,2,0,3
"371","District of Columbia",1991,1,3,0,4
"372","District of Columbia",1990,3,1,0,4
"373","District of Columbia",1989,0,3,0,3
"374","District of Columbia",1988,1,4,0,5
"375","District of Columbia",1987,1,5,0,6
"376","District of Columbia",1986,0,8,0,8
"377","District of Columbia",1985,1,5,0,6
"378","District of Columbia",1984,1,7,0,8
"379","District of Columbia",1983,2,4,0,6
"380","District of Columbia",1982,3,7,0,10
"381","District of Columbia",1981,2,7,0,9
"382","District of Columbia",1980,3,8,0,11
"383","District of Columbia",1979,2,3,0,5
"384","District of Columbia",1978,5,4,0,9
"385","District of Columbia",1977,3,7,0,10
"386","District of Columbia",1976,3,5,0,8
"387","District of Columbia",1975,3,4,0,7
"388","Florida",2017,89,101,20,210
"389","Florida",2016,99,56,26,181
"390","Florida",2015,111,47,17,175
"391","Florida",2014,97,47,11,155
"392","Florida",2013,80,56,16,152
"393","Florida",2012,81,58,17,156
"394","Florida",2011,69,66,19,154
"395","Florida",2010,67,68,15,150
"396","Florida",2009,67,68,15,150
"397","Florida",2008,50,60,8,118
"398","Florida",2007,43,50,11,104
"399","Florida",2006,42,44,8,94
"400","Florida",2005,55,31,5,91
"401","Florida",2004,56,23,3,82
"402","Florida",2003,55,73,8,136
"403","Florida",2002,51,72,10,133
"404","Florida",2001,58,67,10,135
"405","Florida",2000,58,60,9,127
"406","Florida",1999,50,62,8,120
"407","Florida",1998,50,61,3,114
"408","Florida",1997,48,3,59,110
"409","Florida",1996,52,3,60,115
"410","Florida",1995,48,2,50,100
"411","Florida",1994,44,2,33,79
"412","Florida",1993,50,2,35,87
"413","Florida",1992,46,2,36,84
"414","Florida",1991,49,1,26,76
"415","Florida",1990,53,2,25,80
"416","Florida",1989,43,3,23,69
"417","Florida",1988,46,4,27,77
"418","Florida",1987,29,1,25,55
"419","Florida",1986,32,1,23,56
"420","Florida",1985,17,2,27,46
"421","Florida",1984,25,0,30,55
"422","Florida",1983,27,0,28,55
"423","Florida",1982,32,1,37,70
"424","Florida",1981,35,2,30,67
"425","Florida",1980,30,2,30,62
"426","Florida",1979,27,3,41,71
"427","Florida",1978,17,1,34,52
"428","Florida",1977,17,3,37,57
"429","Florida",1976,16,4,31,51
"430","Florida",1975,14,1,31,46
"431","Georgia",2017,89,56,4,149
"432","Georgia",2016,81,33,3,117
"433","Georgia",2015,59,31,3,93
"434","Georgia",2014,54,31,4,89
"435","Georgia",2013,44,23,5,72
"436","Georgia",2012,45,24,4,73
"437","Georgia",2011,46,27,5,78
"438","Georgia",2010,31,32,4,67
"439","Georgia",2009,31,32,4,67
"440","Georgia",2008,28,27,3,58
"441","Georgia",2007,25,25,5,55
"442","Georgia",2006,31,24,6,61
"443","Georgia",2005,21,27,5,53
"444","Georgia",2004,26,21,1,48
"445","Georgia",2003,26,41,3,70
"446","Georgia",2002,32,43,2,77
"447","Georgia",2001,18,38,5,61
"448","Georgia",2000,23,44,5,72
"449","Georgia",1999,21,41,6,68
"450","Georgia",1998,23,39,3,65
"451","Georgia",1997,26,1,37,64
"452","Georgia",1996,31,0,26,57
"453","Georgia",1995,29,2,30,61
"454","Georgia",1994,27,2,15,44
"455","Georgia",1993,29,2,21,52
"456","Georgia",1992,30,1,21,52
"457","Georgia",1991,26,1,17,44
"458","Georgia",1990,22,1,20,43
"459","Georgia",1989,22,2,12,36
"460","Georgia",1988,18,0,9,27
"461","Georgia",1987,24,1,21,46
"462","Georgia",1986,38,1,12,51
"463","Georgia",1985,16,1,15,32
"464","Georgia",1984,15,0,8,23
"465","Georgia",1983,11,0,13,24
"466","Georgia",1982,9,0,15,24
"467","Georgia",1981,6,0,11,17
"468","Georgia",1980,7,0,6,13
"469","Georgia",1979,8,1,8,17
"470","Georgia",1978,3,1,13,17
"471","Georgia",1977,1,1,19,21
"472","Georgia",1976,3,0,24,27
"473","Georgia",1975,3,0,23,26
"474","Guam",2017,1,0,0,1
"475","Guam",2016,1,0,0,1
"476","Guam",2015,1,1,0,2
"477","Guam",2014,1,1,0,2
"478","Guam",2013,0,1,0,1
"479","Hawaii",2017,9,10,0,19
"480","Hawaii",2016,8,9,0,17
"481","Hawaii",2015,7,8,0,15
"482","Hawaii",2014,7,7,0,14
"483","Hawaii",2013,9,10,1,20
"484","Hawaii",2012,6,10,1,17
"485","Hawaii",2011,5,8,1,14
"486","Hawaii",2010,6,9,1,16
"487","Hawaii",2009,6,9,1,16
"488","Hawaii",2008,6,6,1,13
"489","Hawaii",2007,6,5,1,12
"490","Hawaii",2006,8,5,0,13
"491","Hawaii",2005,13,4,0,17
"492","Hawaii",2004,13,3,0,16
"493","Hawaii",2003,23,7,1,31
"494","Hawaii",2002,34,6,0,40
"495","Hawaii",2001,40,7,0,47
"496","Hawaii",2000,54,8,0,62
"497","Hawaii",1999,54,12,0,66
"498","Hawaii",1998,58,6,0,64
"499","Hawaii",1997,53,0,5,58
"500","Hawaii",1996,40,0,7,47
"501","Hawaii",1995,26,0,8,34
"502","Hawaii",1994,16,0,6,22
"503","Hawaii",1993,11,0,6,17
"504","Hawaii",1992,11,0,7,18
"505","Hawaii",1991,8,0,8,16
"506","Hawaii",1990,7,0,12,19
"507","Hawaii",1989,5,0,7,12
"508","Hawaii",1988,5,1,5,11
"509","Hawaii",1987,0,0,0,0
"510","Hawaii",1986,1,0,1,2
"511","Hawaii",1985,2,0,2,4
"512","Hawaii",1984,8,0,9,17
"513","Hawaii",1983,12,0,14,26
"514","Hawaii",1982,10,0,9,19
"515","Hawaii",1981,7,0,5,12
"516","Hawaii",1980,3,0,2,5
"517","Hawaii",1979,2,0,6,8
"518","Hawaii",1978,5,0,12,17
"519","Hawaii",1977,7,0,7,14
"520","Hawaii",1976,7,1,7,15
"521","Hawaii",1975,7,0,9,16
"522","Idaho",2017,5,14,1,20
"523","Idaho",2016,3,12,1,16
"524","Idaho",2015,2,8,1,11
"525","Idaho",2014,5,8,1,14
"526","Idaho",2013,1,6,1,8
"527","Idaho",2012,2,7,2,11
"528","Idaho",2011,3,10,3,16
"529","Idaho",2010,2,10,2,14
"530","Idaho",2009,2,10,2,14
"531","Idaho",2008,2,10,1,13
"532","Idaho",2007,2,8,1,11
"533","Idaho",2006,3,6,2,11
"534","Idaho",2005,5,5,0,10
"535","Idaho",2004,3,3,1,7
"536","Idaho",2003,4,8,0,12
"537","Idaho",2002,2,8,0,10
"538","Idaho",2001,2,8,0,10
"539","Idaho",2000,2,8,0,10
"540","Idaho",1999,3,6,0,9
"541","Idaho",1998,3,6,0,9
"542","Idaho",1997,2,0,8,10
"543","Idaho",1996,3,0,9,12
"544","Idaho",1995,2,0,11,13
"545","Idaho",1994,0,0,7,7
"546","Idaho",1993,1,0,5,6
"547","Idaho",1992,1,0,4,5
"548","Idaho",1991,1,0,6,7
"549","Idaho",1990,0,0,4,4
"550","Idaho",1989,0,0,2,2
"551","Idaho",1988,0,0,1,1
"552","Idaho",1987,1,0,5,6
"553","Idaho",1986,0,0,3,3
"554","Idaho",1985,0,0,7,7
"555","Idaho",1984,0,0,3,3
"556","Idaho",1983,1,0,8,9
"557","Idaho",1982,0,0,7,7
"558","Idaho",1981,1,0,5,6
"559","Idaho",1980,1,0,7,8
"560","Idaho",1979,2,0,7,9
"561","Idaho",1978,0,0,2,2
"562","Idaho",1977,3,0,3,6
"563","Idaho",1976,1,0,5,6
"564","Idaho",1975,1,0,6,7
"565","Illinois",2017,24251,3330,537,28118
"566","Illinois",2016,24169,2458,542,27169
"567","Illinois",2015,23720,2580,607,26907
"568","Illinois",2014,23853,2677,630,27160
"569","Illinois",2013,24299,2825,677,27801
"570","Illinois",2012,24683,2839,701,28223
"571","Illinois",2011,25197,2845,687,28729
"572","Illinois",2010,25465,2901,704,29070
"573","Illinois",2009,25465,2901,704,29070
"574","Illinois",2008,26677,2903,707,30287
"575","Illinois",2007,26848,2894,686,30428
"576","Illinois",2006,27049,2828,703,30580
"577","Illinois",2005,26539,2807,718,30064
"578","Illinois",2004,25494,2941,805,29240
"579","Illinois",2003,25129,3084,825,29038
"580","Illinois",2002,25085,3091,824,29000
"581","Illinois",2001,25106,2904,835,28845
"582","Illinois",2000,25150,2787,787,28724
"583","Illinois",1999,25222,2868,766,28856
"584","Illinois",1998,24807,3096,760,28663
"585","Illinois",1997,24292,762,3414,28468
"586","Illinois",1996,24231,773,3917,28921
"587","Illinois",1995,24408,845,4484,29737
"588","Illinois",1994,24308,845,4927,30080
"589","Illinois",1993,24371,842,5086,30299
"590","Illinois",1992,23992,849,5056,29897
"591","Illinois",1991,24618,869,5068,30555
"592","Illinois",1990,24735,854,4765,30354
"593","Illinois",1989,24479,851,4784,30114
"594","Illinois",1988,25478,852,2995,29325
"595","Illinois",1987,25733,886,5029,31648
"596","Illinois",1986,26024,902,5034,31960
"597","Illinois",1985,26126,895,4823,31844
"598","Illinois",1984,25124,904,4839,30867
"599","Illinois",1983,25083,938,4874,30895
"600","Illinois",1982,25416,928,4971,31315
"601","Illinois",1981,25695,915,4908,31518
"602","Illinois",1980,25615,913,4686,31214
"603","Illinois",1979,25269,903,4775,30947
"604","Illinois",1978,24593,920,4738,30251
"605","Illinois",1977,24557,1036,4938,30531
"606","Illinois",1976,24052,1032,5178,30262
"607","Illinois",1975,25049,1017,5582,31648
"608","Indiana",2017,65,103,17,185
"609","Indiana",2016,58,80,16,154
"610","Indiana",2015,62,76,12,150
"611","Indiana",2014,58,73,9,140
"612","Indiana",2013,57,68,11,136
"613","Indiana",2012,56,78,11,145
"614","Indiana",2011,55,66,11,132
"615","Indiana",2010,49,63,6,118
"616","Indiana",2009,49,63,6,118
"617","Indiana",2008,65,68,3,136
"618","Indiana",2007,74,75,4,153
"619","Indiana",2006,79,57,3,139
"620","Indiana",2005,89,48,1,138
"621","Indiana",2004,95,47,5,147
"622","Indiana",2003,86,123,8,217
"623","Indiana",2002,91,125,8,224
"624","Indiana",2001,87,122,7,216
"625","Indiana",2000,90,107,9,206
"626","Indiana",1999,98,103,9,210
"627","Indiana",1998,90,98,10,198
"628","Indiana",1997,79,10,92,181
"629","Indiana",1996,78,10,96,184
"630","Indiana",1995,68,5,79,152
"631","Indiana",1994,85,5,59,149
"632","Indiana",1993,70,4,67,141
"633","Indiana",1992,86,4,63,153
"634","Indiana",1991,89,2,57,148
"635","Indiana",1990,95,1,71,167
"636","Indiana",1989,94,4,68,166
"637","Indiana",1988,93,6,65,164
"638","Indiana",1987,94,2,77,173
"639","Indiana",1986,76,3,74,153
"640","Indiana",1985,64,2,69,135
"641","Indiana",1984,67,3,74,144
"642","Indiana",1983,49,2,69,120
"643","Indiana",1982,61,3,60,124
"644","Indiana",1981,69,7,78,154
"645","Indiana",1980,68,2,92,162
"646","Indiana",1979,60,2,88,150
"647","Indiana",1978,54,4,93,151
"648","Indiana",1977,57,4,91,152
"649","Indiana",1976,70,2,90,162
"650","Indiana",1975,70,0,83,153
"651","Iowa",2017,39,43,3,85
"652","Iowa",2016,35,39,3,77
"653","Iowa",2015,28,40,1,69
"654","Iowa",2014,29,49,2,80
"655","Iowa",2013,27,51,3,81
"656","Iowa",2012,20,46,2,68
"657","Iowa",2011,32,48,1,81
"658","Iowa",2010,26,53,2,81
"659","Iowa",2009,26,53,2,81
"660","Iowa",2008,29,45,5,79
"661","Iowa",2007,34,42,4,80
"662","Iowa",2006,41,37,4,82
"663","Iowa",2005,40,29,3,72
"664","Iowa",2004,33,34,2,69
"665","Iowa",2003,34,76,2,112
"666","Iowa",2002,31,70,2,103
"667","Iowa",2001,35,59,3,97
"668","Iowa",2000,40,50,2,92
"669","Iowa",1999,47,53,3,103
"670","Iowa",1998,39,59,2,100
"671","Iowa",1997,44,2,61,107
"672","Iowa",1996,36,1,55,92
"673","Iowa",1995,35,0,45,80
"674","Iowa",1994,31,0,31,62
"675","Iowa",1993,28,0,42,70
"676","Iowa",1992,35,0,37,72
"677","Iowa",1991,40,0,38,78
"678","Iowa",1990,45,0,33,78
"679","Iowa",1989,38,1,38,77
"680","Iowa",1988,29,1,21,51
"681","Iowa",1987,25,1,28,54
"682","Iowa",1986,25,0,34,59
"683","Iowa",1985,24,2,42,68
"684","Iowa",1984,23,1,37,61
"685","Iowa",1983,21,1,30,52
"686","Iowa",1982,15,1,40,56
"687","Iowa",1981,18,1,30,49
"688","Iowa",1980,20,1,38,59
"689","Iowa",1979,29,1,44,74
"690","Iowa",1978,29,1,38,68
"691","Iowa",1977,21,1,32,54
"692","Iowa",1976,14,1,34,49
"693","Iowa",1975,14,2,38,54
"694","Kansas",2017,24,26,2,52
"695","Kansas",2016,25,15,2,42
"696","Kansas",2015,19,22,2,43
"697","Kansas",2014,22,30,1,53
"698","Kansas",2013,23,29,1,53
"699","Kansas",2012,20,18,2,40
"700","Kansas",2011,25,15,3,43
"701","Kansas",2010,33,14,5,52
"702","Kansas",2009,33,14,5,52
"703","Kansas",2008,38,15,1,54
"704","Kansas",2007,34,25,0,59
"705","Kansas",2006,35,29,2,66
"706","Kansas",2005,37,24,2,63
"707","Kansas",2004,41,15,2,58
"708","Kansas",2003,46,45,2,93
"709","Kansas",2002,34,40,3,77
"710","Kansas",2001,41,37,4,82
"711","Kansas",2000,35,32,2,69
"712","Kansas",1999,27,24,2,53
"713","Kansas",1998,31,25,1,57
"714","Kansas",1997,31,1,19,51
"715","Kansas",1996,27,0,15,42
"716","Kansas",1995,29,0,17,46
"717","Kansas",1994,26,0,9,35
"718","Kansas",1993,23,1,12,36
"719","Kansas",1992,18,1,10,29
"720","Kansas",1991,16,1,22,39
"721","Kansas",1990,18,3,23,44
"722","Kansas",1989,13,3,21,37
"723","Kansas",1988,12,1,20,33
"724","Kansas",1987,14,1,27,42
"725","Kansas",1986,7,0,4,11
"726","Kansas",1985,13,0,27,40
"727","Kansas",1984,10,1,18,29
"728","Kansas",1983,7,2,27,36
"729","Kansas",1982,11,1,26,38
"730","Kansas",1981,10,1,20,31
"731","Kansas",1980,14,2,22,38
"732","Kansas",1979,8,1,23,32
"733","Kansas",1978,6,0,25,31
"734","Kansas",1977,3,1,34,38
"735","Kansas",1976,3,0,20,23
"736","Kansas",1975,4,0,26,30
"737","Kentucky",2017,30,24,3,57
"738","Kentucky",2016,30,23,3,56
"739","Kentucky",2015,32,23,3,58
"740","Kentucky",2014,33,25,3,61
"741","Kentucky",2013,28,26,3,57
"742","Kentucky",2012,25,20,4,49
"743","Kentucky",2011,23,22,3,48
"744","Kentucky",2010,15,24,4,43
"745","Kentucky",2009,15,24,4,43
"746","Kentucky",2008,25,27,2,54
"747","Kentucky",2007,28,22,2,52
"748","Kentucky",2006,38,26,1,65
"749","Kentucky",2005,40,21,4,65
"750","Kentucky",2004,30,16,3,49
"751","Kentucky",2003,36,36,4,76
"752","Kentucky",2002,34,35,2,71
"753","Kentucky",2001,37,35,1,73
"754","Kentucky",2000,42,33,0,75
"755","Kentucky",1999,43,23,2,68
"756","Kentucky",1998,34,22,3,59
"757","Kentucky",1997,37,5,22,64
"758","Kentucky",1996,32,5,17,54
"759","Kentucky",1995,32,5,17,54
"760","Kentucky",1994,34,5,13,52
"761","Kentucky",1993,44,2,25,71
"762","Kentucky",1992,44,1,26,71
"763","Kentucky",1991,41,1,25,67
"764","Kentucky",1990,42,1,22,65
"765","Kentucky",1989,36,0,23,59
"766","Kentucky",1988,34,0,15,49
"767","Kentucky",1987,39,0,21,60
"768","Kentucky",1986,36,0,26,62
"769","Kentucky",1985,32,0,21,53
"770","Kentucky",1984,28,0,16,44
"771","Kentucky",1983,20,0,14,34
"772","Kentucky",1982,20,0,16,36
"773","Kentucky",1981,11,0,24,35
"774","Kentucky",1980,7,0,21,28
"775","Kentucky",1979,11,1,16,28
"776","Kentucky",1978,12,0,18,30
"777","Kentucky",1977,12,0,21,33
"778","Kentucky",1976,7,0,15,22
"779","Kentucky",1975,7,0,32,39
"780","Louisiana",2017,9,20,2,31
"781","Louisiana",2016,10,16,2,28
"782","Louisiana",2015,12,12,1,25
"783","Louisiana",2014,13,15,1,29
"784","Louisiana",2013,14,14,1,29
"785","Louisiana",2012,8,10,2,20
"786","Louisiana",2011,5,8,2,15
"787","Louisiana",2010,6,10,2,18
"788","Louisiana",2009,6,10,2,18
"789","Louisiana",2008,4,14,1,19
"790","Louisiana",2007,7,15,2,24
"791","Louisiana",2006,12,11,2,25
"792","Louisiana",2005,10,9,0,19
"793","Louisiana",2004,12,9,0,21
"794","Louisiana",2003,8,26,2,36
"795","Louisiana",2002,8,19,2,29
"796","Louisiana",2001,10,20,2,32
"797","Louisiana",2000,12,21,2,35
"798","Louisiana",1999,7,15,0,22
"799","Louisiana",1998,13,13,0,26
"800","Louisiana",1997,17,0,17,34
"801","Louisiana",1996,12,0,20,32
"802","Louisiana",1995,11,0,19,30
"803","Louisiana",1994,12,0,20,32
"804","Louisiana",1993,9,1,16,26
"805","Louisiana",1992,6,0,13,19
"806","Louisiana",1991,7,1,17,25
"807","Louisiana",1990,8,2,12,22
"808","Louisiana",1989,4,1,8,13
"809","Louisiana",1988,4,1,7,12
"810","Louisiana",1987,5,0,6,11
"811","Louisiana",1986,5,0,11,16
"812","Louisiana",1985,6,0,17,23
"813","Louisiana",1984,4,0,12,16
"814","Louisiana",1983,2,0,11,13
"815","Louisiana",1982,3,0,6,9
"816","Louisiana",1981,5,0,9,14
"817","Louisiana",1980,2,0,8,10
"818","Louisiana",1979,2,0,12,14
"819","Louisiana",1978,2,0,10,12
"820","Louisiana",1977,4,1,18,23
"821","Louisiana",1976,2,1,24,27
"822","Louisiana",1975,2,0,17,19
"823","Maine",2017,3,12,0,15
"824","Maine",2016,5,9,0,14
"825","Maine",2015,4,8,2,14
"826","Maine",2014,3,6,1,10
"827","Maine",2013,3,4,1,8
"828","Maine",2012,5,2,3,10
"829","Maine",2011,2,5,1,8
"830","Maine",2010,2,7,1,10
"831","Maine",2009,2,7,1,10
"832","Maine",2008,3,6,1,10
"833","Maine",2007,2,6,0,8
"834","Maine",2006,2,4,0,6
"835","Maine",2005,3,5,0,8
"836","Maine",2004,5,2,1,8
"837","Maine",2003,8,7,2,17
"838","Maine",2002,6,9,1,16
"839","Maine",2001,4,12,1,17
"840","Maine",2000,6,7,0,13
"841","Maine",1999,3,8,1,12
"842","Maine",1998,3,9,2,14
"843","Maine",1997,7,2,8,17
"844","Maine",1996,1,2,12,15
"845","Maine",1995,3,0,7,10
"846","Maine",1994,1,0,7,8
"847","Maine",1993,0,0,4,4
"848","Maine",1992,3,0,2,5
"849","Maine",1991,4,0,1,5
"850","Maine",1990,4,0,0,4
"851","Maine",1989,3,0,1,4
"852","Maine",1988,2,0,2,4
"853","Maine",1987,1,0,1,2
"854","Maine",1986,2,0,4,6
"855","Maine",1985,1,0,4,5
"856","Maine",1984,1,0,3,4
"857","Maine",1983,2,0,2,4
"858","Maine",1982,1,0,3,4
"859","Maine",1981,2,0,5,7
"860","Maine",1980,1,0,3,4
"861","Maine",1979,1,0,4,5
"862","Maine",1978,0,0,7,7
"863","Maine",1977,1,0,8,9
"864","Maine",1976,1,0,9,10
"865","Maine",1975,1,0,5,6
"866","Maryland",2017,62,69,5,136
"867","Maryland",2016,66,46,7,119
"868","Maryland",2015,73,45,5,123
"869","Maryland",2014,78,43,7,128
"870","Maryland",2013,74,45,5,124
"871","Maryland",2012,67,41,6,114
"872","Maryland",2011,67,47,4,118
"873","Maryland",2010,62,41,2,105
"874","Maryland",2009,62,41,2,105
"875","Maryland",2008,74,43,3,120
"876","Maryland",2007,76,41,4,121
"877","Maryland",2006,80,40,5,125
"878","Maryland",2005,85,36,7,128
"879","Maryland",2004,89,30,9,128
"880","Maryland",2003,100,60,8,168
"881","Maryland",2002,81,54,6,141
"882","Maryland",2001,79,53,7,139
"883","Maryland",2000,69,46,5,120
"884","Maryland",1999,66,41,1,108
"885","Maryland",1998,77,44,3,124
"886","Maryland",1997,76,4,44,124
"887","Maryland",1996,77,5,46,128
"888","Maryland",1995,73,1,36,110
"889","Maryland",1994,57,1,37,95
"890","Maryland",1993,47,1,39,87
"891","Maryland",1992,44,0,34,78
"892","Maryland",1991,34,1,36,71
"893","Maryland",1990,30,3,28,61
"894","Maryland",1989,20,2,23,45
"895","Maryland",1988,21,1,14,36
"896","Maryland",1987,26,0,23,49
"897","Maryland",1986,25,1,23,49
"898","Maryland",1985,22,0,17,39
"899","Maryland",1984,18,0,18,36
"900","Maryland",1983,13,0,28,41
"901","Maryland",1982,7,0,32,39
"902","Maryland",1981,8,2,38,48
"903","Maryland",1980,10,1,32,43
"904","Maryland",1979,6,2,18,26
"905","Maryland",1978,5,1,29,35
"906","Maryland",1977,6,0,28,34
"907","Maryland",1976,13,0,34,47
"908","Maryland",1975,10,1,43,54
"909","Massachusetts",2017,98,72,14,184
"910","Massachusetts",2016,105,45,10,160
"911","Massachusetts",2015,106,33,9,148
"912","Massachusetts",2014,102,36,10,148
"913","Massachusetts",2013,100,34,7,141
"914","Massachusetts",2012,94,42,8,144
"915","Massachusetts",2011,92,38,5,135
"916","Massachusetts",2010,80,35,3,118
"917","Massachusetts",2009,80,35,3,118
"918","Massachusetts",2008,65,20,3,88
"919","Massachusetts",2007,59,22,3,84
"920","Massachusetts",2006,51,15,5,71
"921","Massachusetts",2005,56,20,3,79
"922","Massachusetts",2004,53,25,9,87
"923","Massachusetts",2003,51,69,10,130
"924","Massachusetts",2002,43,65,10,118
"925","Massachusetts",2001,48,60,8,116
"926","Massachusetts",2000,48,48,5,101
"927","Massachusetts",1999,45,56,4,105
"928","Massachusetts",1998,48,47,6,101
"929","Massachusetts",1997,40,7,41,88
"930","Massachusetts",1996,41,7,42,90
"931","Massachusetts",1995,44,0,32,76
"932","Massachusetts",1994,36,0,25,61
"933","Massachusetts",1993,46,0,26,72
"934","Massachusetts",1992,43,0,26,69
"935","Massachusetts",1991,38,0,26,64
"936","Massachusetts",1990,26,1,24,51
"937","Massachusetts",1989,30,1,23,54
"938","Massachusetts",1988,18,1,27,46
"939","Massachusetts",1987,18,0,30,48
"940","Massachusetts",1986,12,1,37,50
"941","Massachusetts",1985,10,0,40,50
"942","Massachusetts",1984,10,3,28,41
"943","Massachusetts",1983,8,1,36,45
"944","Massachusetts",1982,12,0,39,51
"945","Massachusetts",1981,16,0,41,57
"946","Massachusetts",1980,10,1,46,57
"947","Massachusetts",1979,12,2,44,58
"948","Massachusetts",1978,16,2,47,65
"949","Massachusetts",1977,13,0,30,43
"950","Massachusetts",1976,12,4,39,55
"951","Massachusetts",1975,12,4,46,62
"952","Michigan",2017,86,131,41,258
"953","Michigan",2016,81,101,46,228
"954","Michigan",2015,76,110,39,225
"955","Michigan",2014,85,114,34,233
"956","Michigan",2013,83,105,29,217
"957","Michigan",2012,63,89,36,188
"958","Michigan",2011,65,82,40,187
"959","Michigan",2010,50,84,38,172
"960","Michigan",2009,50,84,38,172
"961","Michigan",2008,60,75,17,152
"962","Michigan",2007,63,55,17,135
"963","Michigan",2006,79,67,17,163
"964","Michigan",2005,68,65,14,147
"965","Michigan",2004,68,54,20,142
"966","Michigan",2003,71,134,27,232
"967","Michigan",2002,68,119,21,208
"968","Michigan",2001,67,106,18,191
"969","Michigan",2000,56,98,15,169
"970","Michigan",1999,54,99,14,167
"971","Michigan",1998,62,102,12,176
"972","Michigan",1997,55,18,110,183
"973","Michigan",1996,61,19,111,191
"974","Michigan",1995,58,10,95,163
"975","Michigan",1994,57,10,76,143
"976","Michigan",1993,56,13,74,143
"977","Michigan",1992,42,14,85,141
"978","Michigan",1991,44,9,81,134
"979","Michigan",1990,38,6,100,144
"980","Michigan",1989,37,1,74,112
"981","Michigan",1988,32,4,72,108
"982","Michigan",1987,40,5,71,116
"983","Michigan",1986,35,9,70,114
"984","Michigan",1985,31,6,67,104
"985","Michigan",1984,26,11,72,109
"986","Michigan",1983,28,9,55,92
"987","Michigan",1982,24,7,60,91
"988","Michigan",1981,25,6,75,106
"989","Michigan",1980,30,11,69,110
"990","Michigan",1979,27,9,63,99
"991","Michigan",1978,20,5,55,80
"992","Michigan",1977,28,2,64,94
"993","Michigan",1976,21,4,73,98
"994","Michigan",1975,15,6,58,79
"995","Military",2017,6,3,1,10
"996","Military",2016,8,1,0,9
"997","Military",2015,7,3,0,10
"998","Military",2014,6,1,0,7
"999","Military",2013,4,1,0,5
"1000","Military",2012,7,0,0,7
"1001","Military",2011,11,0,0,11
"1002","Military",2010,7,0,0,7
"1003","Military",2009,7,0,0,7
"1004","Military",2008,6,0,0,6
"1005","Military",2007,3,0,0,3
"1006","Military",2006,1,0,0,1
"1007","Military",2005,2,0,0,2
"1008","Military",2004,6,0,0,6
"1009","Military",2003,1,2,0,3
"1010","Military",2002,1,1,0,2
"1011","Military",2001,0,0,0,0
"1012","Military",2000,1,0,0,1
"1013","Minnesota",2017,77,77,7,161
"1014","Minnesota",2016,80,52,9,141
"1015","Minnesota",2015,71,51,4,126
"1016","Minnesota",2014,69,50,5,124
"1017","Minnesota",2013,53,49,6,108
"1018","Minnesota",2012,58,48,6,112
"1019","Minnesota",2011,56,53,6,115
"1020","Minnesota",2010,43,60,4,107
"1021","Minnesota",2009,43,60,4,107
"1022","Minnesota",2008,37,43,3,83
"1023","Minnesota",2007,39,43,0,82
"1024","Minnesota",2006,44,38,2,84
"1025","Minnesota",2005,48,25,1,74
"1026","Minnesota",2004,60,25,2,87
"1027","Minnesota",2003,58,89,0,147
"1028","Minnesota",2002,64,77,0,141
"1029","Minnesota",2001,72,75,0,147
"1030","Minnesota",2000,69,64,0,133
"1031","Minnesota",1999,73,63,2,138
"1032","Minnesota",1998,56,67,2,125
"1033","Minnesota",1997,46,2,59,107
"1034","Minnesota",1996,4,0,54,58
"1035","Minnesota",1995,33,1,55,89
"1036","Minnesota",1994,30,1,39,70
"1037","Minnesota",1993,28,1,35,64
"1038","Minnesota",1992,19,1,43,63
"1039","Minnesota",1991,19,2,36,57
"1040","Minnesota",1990,23,1,3,27
"1041","Minnesota",1989,25,0,31,56
"1042","Minnesota",1988,23,0,29,52
"1043","Minnesota",1987,22,1,33,56
"1044","Minnesota",1986,15,1,36,52
"1045","Minnesota",1985,14,0,53,67
"1046","Minnesota",1984,11,0,58,69
"1047","Minnesota",1983,11,0,59,70
"1048","Minnesota",1982,9,1,44,54
"1049","Minnesota",1981,13,1,45,59
"1050","Minnesota",1980,9,1,45,55
"1051","Minnesota",1979,8,0,33,41
"1052","Minnesota",1978,9,0,36,45
"1053","Minnesota",1977,7,2,48,57
"1054","Minnesota",1976,6,2,38,46
"1055","Minnesota",1975,12,3,33,48
"1056","Mississippi",2017,6,10,0,16
"1057","Mississippi",2016,5,6,0,11
"1058","Mississippi",2015,4,6,0,10
"1059","Mississippi",2014,3,8,0,11
"1060","Mississippi",2013,6,10,0,16
"1061","Mississippi",2012,5,8,1,14
"1062","Mississippi",2011,4,7,1,12
"1063","Mississippi",2010,2,8,1,11
"1064","Mississippi",2009,2,8,1,11
"1065","Mississippi",2008,5,5,0,10
"1066","Mississippi",2007,6,3,0,9
"1067","Mississippi",2006,4,4,1,9
"1068","Mississippi",2005,5,5,1,11
"1069","Mississippi",2004,4,4,0,8
"1070","Mississippi",2003,1,13,0,14
"1071","Mississippi",2002,3,14,0,17
"1072","Mississippi",2001,2,12,0,14
"1073","Mississippi",2000,4,12,0,16
"1074","Mississippi",1999,2,13,0,15
"1075","Mississippi",1998,4,18,0,22
"1076","Mississippi",1997,7,1,11,19
"1077","Mississippi",1996,6,1,10,17
"1078","Mississippi",1995,7,0,6,13
"1079","Mississippi",1994,8,0,7,15
"1080","Mississippi",1993,5,0,10,15
"1081","Mississippi",1992,4,0,7,11
"1082","Mississippi",1991,2,0,9,11
"1083","Mississippi",1990,0,0,7,7
"1084","Mississippi",1989,0,0,6,6
"1085","Mississippi",1988,2,0,6,8
"1086","Mississippi",1987,2,0,4,6
"1087","Mississippi",1986,2,0,3,5
"1088","Mississippi",1985,2,1,5,8
"1089","Mississippi",1984,2,0,4,6
"1090","Mississippi",1983,1,0,5,6
"1091","Mississippi",1982,1,0,3,4
"1092","Mississippi",1981,5,0,6,11
"1093","Mississippi",1980,4,0,7,11
"1094","Mississippi",1979,3,0,2,5
"1095","Mississippi",1978,6,0,6,12
"1096","Mississippi",1977,2,0,12,14
"1097","Mississippi",1976,1,0,12,13
"1098","Mississippi",1975,0,0,16,16
"1099","Missouri",2017,122,127,10,259
"1100","Missouri",2016,134,75,6,215
"1101","Missouri",2015,138,67,9,214
"1102","Missouri",2014,141,73,10,224
"1103","Missouri",2013,138,84,9,231
"1104","Missouri",2012,140,92,12,244
"1105","Missouri",2011,133,78,11,222
"1106","Missouri",2010,133,82,12,227
"1107","Missouri",2009,133,82,12,227
"1108","Missouri",2008,167,72,8,247
"1109","Missouri",2007,174,67,9,250
"1110","Missouri",2006,202,66,8,276
"1111","Missouri",2005,227,45,6,278
"1112","Missouri",2004,244,41,5,290
"1113","Missouri",2003,289,123,4,416
"1114","Missouri",2002,286,109,6,401
"1115","Missouri",2001,298,113,3,414
"1116","Missouri",2000,284,103,5,392
"1117","Missouri",1999,284,106,9,399
"1118","Missouri",1998,288,107,14,409
"1119","Missouri",1997,280,15,96,391
"1120","Missouri",1996,276,13,81,370
"1121","Missouri",1995,232,8,76,316
"1122","Missouri",1994,227,8,69,304
"1123","Missouri",1993,191,5,80,276
"1124","Missouri",1992,169,2,88,259
"1125","Missouri",1991,181,5,69,255
"1126","Missouri",1990,177,6,60,243
"1127","Missouri",1989,159,6,62,227
"1128","Missouri",1988,167,7,56,230
"1129","Missouri",1987,174,5,71,250
"1130","Missouri",1986,165,10,64,239
"1131","Missouri",1985,169,0,61,230
"1132","Missouri",1984,137,3,53,193
"1133","Missouri",1983,128,4,62,194
"1134","Missouri",1982,112,5,9,126
"1135","Missouri",1981,96,7,61,164
"1136","Missouri",1980,86,4,76,166
"1137","Missouri",1979,78,0,63,141
"1138","Missouri",1978,66,4,67,137
"1139","Missouri",1977,63,2,59,124
"1140","Missouri",1976,54,3,61,118
"1141","Missouri",1975,56,2,73,131
"1142","Montana",2017,1,3,0,4
"1143","Montana",2016,0,4,0,4
"1144","Montana",2015,0,3,0,3
"1145","Montana",2014,0,3,0,3
"1146","Montana",2013,0,3,0,3
"1147","Montana",2012,0,6,0,6
"1148","Montana",2011,0,6,0,6
"1149","Montana",2010,1,4,0,5
"1150","Montana",2009,1,4,0,5
"1151","Montana",2008,1,3,0,4
"1152","Montana",2007,1,3,0,4
"1153","Montana",2006,0,2,0,2
"1154","Montana",2005,1,2,0,3
"1155","Montana",2004,3,5,0,8
"1156","Montana",2003,2,7,1,10
"1157","Montana",2002,4,8,1,13
"1158","Montana",2001,1,9,1,11
"1159","Montana",2000,2,7,1,10
"1160","Montana",1999,3,5,1,9
"1161","Montana",1998,2,3,1,6
"1162","Montana",1997,3,0,9,12
"1163","Montana",1996,2,0,5,7
"1164","Montana",1995,4,0,3,7
"1165","Montana",1994,4,0,3,7
"1166","Montana",1993,3,0,6,9
"1167","Montana",1992,2,0,3,5
"1168","Montana",1991,3,0,0,3
"1169","Montana",1990,2,0,1,3
"1170","Montana",1989,1,0,4,5
"1171","Montana",1988,1,0,2,3
"1172","Montana",1987,3,0,4,7
"1173","Montana",1986,4,0,5,9
"1174","Montana",1985,3,0,9,12
"1175","Montana",1984,1,0,8,9
"1176","Montana",1983,2,0,7,9
"1177","Montana",1982,1,0,4,5
"1178","Montana",1981,3,0,4,7
"1179","Montana",1980,0,0,4,4
"1180","Montana",1979,0,0,4,4
"1181","Montana",1978,0,0,4,4
"1182","Montana",1977,1,1,5,7
"1183","Montana",1976,0,0,2,2
"1184","Montana",1975,0,0,4,4
"1185","Nebraska",2017,7,28,1,36
"1186","Nebraska",2016,7,18,3,28
"1187","Nebraska",2015,5,19,2,26
"1188","Nebraska",2014,11,16,1,28
"1189","Nebraska",2013,10,16,0,26
"1190","Nebraska",2012,11,14,1,26
"1191","Nebraska",2011,12,14,2,28
"1192","Nebraska",2010,8,22,2,32
"1193","Nebraska",2009,8,22,2,32
"1194","Nebraska",2008,14,15,2,31
"1195","Nebraska",2007,15,18,2,35
"1196","Nebraska",2006,20,17,2,39
"1197","Nebraska",2005,18,14,1,33
"1198","Nebraska",2004,18,11,1,30
"1199","Nebraska",2003,21,26,0,47
"1200","Nebraska",2002,28,26,1,55
"1201","Nebraska",2001,29,28,1,58
"1202","Nebraska",2000,37,20,1,58
"1203","Nebraska",1999,42,14,0,56
"1204","Nebraska",1998,39,16,1,56
"1205","Nebraska",1997,35,1,19,55
"1206","Nebraska",1996,30,2,19,51
"1207","Nebraska",1995,21,1,19,41
"1208","Nebraska",1994,12,1,12,25
"1209","Nebraska",1993,10,0,13,23
"1210","Nebraska",1992,14,0,13,27
"1211","Nebraska",1991,14,0,14,28
"1212","Nebraska",1990,18,0,1,19
"1213","Nebraska",1989,16,1,8,25
"1214","Nebraska",1988,14,1,13,28
"1215","Nebraska",1987,16,0,10,26
"1216","Nebraska",1986,7,1,18,26
"1217","Nebraska",1985,17,1,18,36
"1218","Nebraska",1984,18,0,20,38
"1219","Nebraska",1983,11,0,15,26
"1220","Nebraska",1982,11,0,10,21
"1221","Nebraska",1981,7,0,10,17
"1222","Nebraska",1980,8,1,15,24
"1223","Nebraska",1979,6,1,14,21
"1224","Nebraska",1978,12,1,13,26
"1225","Nebraska",1977,11,0,15,26
"1226","Nebraska",1976,10,0,16,26
"1227","Nebraska",1975,11,0,20,31
"1228","Nevada",2017,11,7,3,21
"1229","Nevada",2016,8,5,3,16
"1230","Nevada",2015,8,6,2,16
"1231","Nevada",2014,9,5,1,15
"1232","Nevada",2013,8,4,1,13
"1233","Nevada",2012,9,6,1,16
"1234","Nevada",2011,9,5,0,14
"1235","Nevada",2010,8,6,0,14
"1236","Nevada",2009,8,6,0,14
"1237","Nevada",2008,11,3,0,14
"1238","Nevada",2007,11,4,0,15
"1239","Nevada",2006,10,2,0,12
"1240","Nevada",2005,7,1,0,8
"1241","Nevada",2004,6,1,1,8
"1242","Nevada",2003,11,4,2,17
"1243","Nevada",2002,11,3,2,16
"1244","Nevada",2001,10,4,1,15
"1245","Nevada",2000,12,8,0,20
"1246","Nevada",1999,10,8,0,18
"1247","Nevada",1998,10,3,0,13
"1248","Nevada",1997,10,0,6,16
"1249","Nevada",1996,6,0,7,13
"1250","Nevada",1995,7,0,4,11
"1251","Nevada",1994,6,0,3,9
"1252","Nevada",1993,6,0,1,7
"1253","Nevada",1992,7,1,0,8
"1254","Nevada",1991,2,0,4,6
"1255","Nevada",1990,2,0,3,5
"1256","Nevada",1989,2,0,2,4
"1257","Nevada",1988,2,0,5,7
"1258","Nevada",1987,2,0,3,5
"1259","Nevada",1986,1,0,1,2
"1260","Nevada",1985,2,1,2,5
"1261","Nevada",1984,2,0,1,3
"1262","Nevada",1983,0,0,1,1
"1263","Nevada",1982,1,0,2,3
"1264","Nevada",1981,0,0,2,2
"1265","Nevada",1980,0,0,2,2
"1266","Nevada",1979,0,0,1,1
"1267","Nevada",1978,0,0,2,2
"1268","Nevada",1977,1,0,4,5
"1269","Nevada",1976,1,0,2,3
"1270","Nevada",1975,1,0,0,1
"1271","New Hampshire",2017,16,10,1,27
"1272","New Hampshire",2016,17,7,1,25
"1273","New Hampshire",2015,13,11,1,25
"1274","New Hampshire",2014,11,12,1,24
"1275","New Hampshire",2013,10,15,2,27
"1276","New Hampshire",2012,8,13,1,22
"1277","New Hampshire",2011,7,11,1,19
"1278","New Hampshire",2010,9,8,0,17
"1279","New Hampshire",2009,9,8,0,17
"1280","New Hampshire",2008,9,5,1,15
"1281","New Hampshire",2007,12,3,1,16
"1282","New Hampshire",2006,15,4,2,21
"1283","New Hampshire",2005,12,3,2,17
"1284","New Hampshire",2004,7,2,2,11
"1285","New Hampshire",2003,8,12,3,23
"1286","New Hampshire",2002,7,12,2,21
"1287","New Hampshire",2001,5,11,2,18
"1288","New Hampshire",2000,5,12,2,19
"1289","New Hampshire",1999,5,11,0,16
"1290","New Hampshire",1998,4,10,0,14
"1291","New Hampshire",1997,8,0,8,16
"1292","New Hampshire",1996,7,0,10,17
"1293","New Hampshire",1995,7,0,10,17
"1294","New Hampshire",1994,6,0,7,13
"1295","New Hampshire",1993,7,0,8,15
"1296","New Hampshire",1992,9,0,5,14
"1297","New Hampshire",1991,9,0,4,13
"1298","New Hampshire",1990,9,0,6,15
"1299","New Hampshire",1989,5,0,4,9
"1300","New Hampshire",1988,4,0,2,6
"1301","New Hampshire",1987,4,0,4,8
"1302","New Hampshire",1986,5,0,6,11
"1303","New Hampshire",1985,2,1,5,8
"1304","New Hampshire",1984,1,1,8,10
"1305","New Hampshire",1983,0,0,1,1
"1306","New Hampshire",1982,1,0,1,2
"1307","New Hampshire",1981,1,0,7,8
"1308","New Hampshire",1980,0,0,8,8
"1309","New Hampshire",1979,3,0,13,16
"1310","New Hampshire",1978,1,0,12,13
"1311","New Hampshire",1977,2,0,11,13
"1312","New Hampshire",1976,2,0,11,13
"1313","New Hampshire",1975,2,0,9,11
"1314","New Jersey",2017,328,88,14,430
"1315","New Jersey",2016,312,49,17,378
"1316","New Jersey",2015,317,42,13,372
"1317","New Jersey",2014,280,44,14,338
"1318","New Jersey",2013,243,48,8,299
"1319","New Jersey",2012,207,49,8,264
"1320","New Jersey",2011,195,45,11,251
"1321","New Jersey",2010,169,41,13,223
"1322","New Jersey",2009,169,41,13,223
"1323","New Jersey",2008,157,31,12,200
"1324","New Jersey",2007,130,29,15,174
"1325","New Jersey",2006,138,32,15,185
"1326","New Jersey",2005,154,28,14,196
"1327","New Jersey",2004,158,28,12,198
"1328","New Jersey",2003,155,76,10,241
"1329","New Jersey",2002,125,71,8,204
"1330","New Jersey",2001,125,75,8,208
"1331","New Jersey",2000,110,74,7,191
"1332","New Jersey",1999,108,60,10,178
"1333","New Jersey",1998,117,57,6,180
"1334","New Jersey",1997,106,8,58,172
"1335","New Jersey",1996,123,9,53,185
"1336","New Jersey",1995,109,2,49,160
"1337","New Jersey",1994,107,2,47,156
"1338","New Jersey",1993,93,4,42,139
"1339","New Jersey",1992,82,4,36,122
"1340","New Jersey",1991,77,4,37,118
"1341","New Jersey",1990,76,2,37,115
"1342","New Jersey",1989,68,5,30,103
"1343","New Jersey",1988,65,5,30,100
"1344","New Jersey",1987,68,2,35,105
"1345","New Jersey",1986,57,1,30,88
"1346","New Jersey",1985,64,0,39,103
"1347","New Jersey",1984,49,3,43,95
"1348","New Jersey",1983,43,2,39,84
"1349","New Jersey",1982,35,4,49,88
"1350","New Jersey",1981,34,3,51,88
"1351","New Jersey",1980,32,4,46,82
"1352","New Jersey",1979,29,1,57,87
"1353","New Jersey",1978,36,3,43,82
"1354","New Jersey",1977,39,5,51,95
"1355","New Jersey",1976,36,5,47,88
"1356","New Jersey",1975,46,2,58,106
"1357","New Mexico",2017,8,24,0,32
"1358","New Mexico",2016,8,18,1,27
"1359","New Mexico",2015,7,11,1,19
"1360","New Mexico",2014,6,10,1,17
"1361","New Mexico",2013,3,11,1,15
"1362","New Mexico",2012,7,12,0,19
"1363","New Mexico",2011,7,13,0,20
"1364","New Mexico",2010,4,14,0,18
"1365","New Mexico",2009,4,14,0,18
"1366","New Mexico",2008,3,16,0,19
"1367","New Mexico",2007,6,13,1,20
"1368","New Mexico",2006,5,10,2,17
"1369","New Mexico",2005,7,9,2,18
"1370","New Mexico",2004,9,9,1,19
"1371","New Mexico",2003,10,24,0,34
"1372","New Mexico",2002,10,24,0,34
"1373","New Mexico",2001,7,23,0,30
"1374","New Mexico",2000,7,25,0,32
"1375","New Mexico",1999,14,29,1,44
"1376","New Mexico",1998,12,28,1,41
"1377","New Mexico",1997,12,1,27,40
"1378","New Mexico",1996,12,1,27,40
"1379","New Mexico",1995,4,0,21,25
"1380","New Mexico",1994,3,0,24,27
"1381","New Mexico",1993,6,0,13,19
"1382","New Mexico",1992,7,0,10,17
"1383","New Mexico",1991,6,0,12,18
"1384","New Mexico",1990,5,0,14,19
"1385","New Mexico",1989,5,0,10,15
"1386","New Mexico",1988,6,0,14,20
"1387","New Mexico",1987,6,0,11,17
"1388","New Mexico",1986,4,0,13,17
"1389","New Mexico",1985,5,0,17,22
"1390","New Mexico",1984,5,1,13,19
"1391","New Mexico",1983,5,1,16,22
"1392","New Mexico",1982,4,0,13,17
"1393","New Mexico",1981,2,0,11,13
"1394","New Mexico",1980,1,0,11,12
"1395","New Mexico",1979,3,0,10,13
"1396","New Mexico",1978,5,0,14,19
"1397","New Mexico",1977,2,0,17,19
"1398","New Mexico",1976,1,0,15,16
"1399","New Mexico",1975,1,0,14,15
"1400","New York",2017,176,154,19,349
"1401","New York",2016,176,98,19,293
"1402","New York",2015,182,98,12,292
"1403","New York",2014,166,99,16,281
"1404","New York",2013,137,106,16,259
"1405","New York",2012,125,101,22,248
"1406","New York",2011,98,92,23,213
"1407","New York",2010,90,79,23,192
"1408","New York",2009,90,79,23,192
"1409","New York",2008,76,73,16,165
"1410","New York",2007,72,75,15,162
"1411","New York",2006,84,81,18,183
"1412","New York",2005,100,56,12,168
"1413","New York",2004,102,56,10,168
"1414","New York",2003,121,153,15,289
"1415","New York",2002,122,153,20,295
"1416","New York",2001,119,135,16,270
"1417","New York",2000,115,136,23,274
"1418","New York",1999,119,131,21,271
"1419","New York",1998,120,143,17,280
"1420","New York",1997,124,13,137,274
"1421","New York",1996,127,12,131,270
"1422","New York",1995,124,12,107,243
"1423","New York",1994,107,12,83,202
"1424","New York",1993,108,14,96,218
"1425","New York",1992,96,11,114,221
"1426","New York",1991,89,5,91,185
"1427","New York",1990,88,3,96,187
"1428","New York",1989,69,6,89,164
"1429","New York",1988,69,7,86,162
"1430","New York",1987,59,3,82,144
"1431","New York",1986,52,4,84,140
"1432","New York",1985,46,2,105,153
"1433","New York",1984,34,2,115,151
"1434","New York",1983,27,3,126,156
"1435","New York",1982,29,5,119,153
"1436","New York",1981,3,5,128,136
"1437","New York",1980,28,9,124,161
"1438","New York",1979,39,8,137,184
"1439","New York",1978,41,6,164,211
"1440","New York",1977,53,6,149,208
"1441","New York",1976,52,6,187,245
"1442","New York",1975,55,4,218,277
"1443","North Carolina",2017,31,57,3,91
"1444","North Carolina",2016,28,44,1,73
"1445","North Carolina",2015,26,38,1,65
"1446","North Carolina",2014,26,36,1,63
"1447","North Carolina",2013,24,32,1,57
"1448","North Carolina",2012,25,32,1,58
"1449","North Carolina",2011,27,28,3,58
"1450","North Carolina",2010,18,31,5,54
"1451","North Carolina",2009,18,31,5,54
"1452","North Carolina",2008,25,36,4,65
"1453","North Carolina",2007,16,27,3,46
"1454","North Carolina",2006,20,24,4,48
"1455","North Carolina",2005,26,26,1,53
"1456","North Carolina",2004,25,33,1,59
"1457","North Carolina",2003,22,60,12,94
"1458","North Carolina",2002,22,43,7,72
"1459","North Carolina",2001,19,43,5,67
"1460","North Carolina",2000,16,46,3,65
"1461","North Carolina",1999,14,47,2,63
"1462","North Carolina",1998,19,43,3,65
"1463","North Carolina",1997,19,3,45,67
"1464","North Carolina",1996,22,2,39,63
"1465","North Carolina",1995,29,0,36,65
"1466","North Carolina",1994,30,0,31,61
"1467","North Carolina",1993,23,0,29,52
"1468","North Carolina",1992,14,0,17,31
"1469","North Carolina",1991,16,1,18,35
"1470","North Carolina",1990,8,1,23,32
"1471","North Carolina",1989,10,1,14,25
"1472","North Carolina",1988,7,0,19,26
"1473","North Carolina",1987,7,0,5,12
"1474","North Carolina",1986,1,0,20,21
"1475","North Carolina",1985,3,1,23,27
"1476","North Carolina",1984,6,0,22,28
"1477","North Carolina",1983,5,0,27,32
"1478","North Carolina",1982,5,0,27,32
"1479","North Carolina",1981,6,0,33,39
"1480","North Carolina",1980,3,0,30,33
"1481","North Carolina",1979,4,0,29,33
"1482","North Carolina",1978,3,0,29,32
"1483","North Carolina",1977,6,1,39,46
"1484","North Carolina",1976,4,0,33,37
"1485","North Carolina",1975,9,0,30,39
"1486","North Dakota",2017,0,4,1,5
"1487","North Dakota",2016,1,1,0,2
"1488","North Dakota",2015,0,1,1,2
"1489","North Dakota",2014,0,4,1,5
"1490","North Dakota",2013,0,4,1,5
"1491","North Dakota",2012,0,3,0,3
"1492","North Dakota",2011,0,6,0,6
"1493","North Dakota",2010,1,5,0,6
"1494","North Dakota",2009,1,5,0,6
"1495","North Dakota",2008,1,3,1,5
"1496","North Dakota",2007,3,3,1,7
"1497","North Dakota",2006,3,1,0,4
"1498","North Dakota",2005,2,3,0,5
"1499","North Dakota",2004,3,2,0,5
"1500","North Dakota",2003,5,6,0,11
"1501","North Dakota",2002,3,6,0,9
"1502","North Dakota",2001,5,6,0,11
"1503","North Dakota",2000,4,7,1,12
"1504","North Dakota",1999,2,5,1,8
"1505","North Dakota",1998,1,6,0,7
"1506","North Dakota",1997,0,0,8,8
"1507","North Dakota",1996,3,0,9,12
"1508","North Dakota",1995,3,0,7,10
"1509","North Dakota",1994,2,0,6,8
"1510","North Dakota",1993,2,0,4,6
"1511","North Dakota",1992,1,0,4,5
"1512","North Dakota",1991,1,0,6,7
"1513","North Dakota",1990,2,0,5,7
"1514","North Dakota",1989,0,0,4,4
"1515","North Dakota",1988,0,0,3,3
"1516","North Dakota",1987,1,0,6,7
"1517","North Dakota",1986,1,0,10,11
"1518","North Dakota",1985,1,0,4,5
"1519","North Dakota",1984,2,0,8,10
"1520","North Dakota",1983,0,0,5,5
"1521","North Dakota",1982,0,0,4,4
"1522","North Dakota",1981,1,1,3,5
"1523","North Dakota",1980,0,1,3,4
"1524","North Dakota",1979,1,1,7,9
"1525","North Dakota",1978,1,1,8,10
"1526","North Dakota",1977,1,0,6,7
"1527","North Dakota",1976,1,0,6,7
"1528","North Dakota",1975,3,0,3,6
"1529","Ohio",2017,101,103,22,226
"1530","Ohio",2016,129,79,13,221
"1531","Ohio",2015,144,84,13,241
"1532","Ohio",2014,135,76,7,218
"1533","Ohio",2013,123,74,13,210
"1534","Ohio",2012,127,66,17,210
"1535","Ohio",2011,126,69,21,216
"1536","Ohio",2010,121,74,19,214
"1537","Ohio",2009,121,74,19,214
"1538","Ohio",2008,113,75,12,200
"1539","Ohio",2007,104,65,12,181
"1540","Ohio",2006,115,69,8,192
"1541","Ohio",2005,131,72,3,206
"1542","Ohio",2004,139,56,4,199
"1543","Ohio",2003,161,136,7,304
"1544","Ohio",2002,161,124,11,296
"1545","Ohio",2001,161,129,10,300
"1546","Ohio",2000,174,139,11,324
"1547","Ohio",1999,189,121,7,317
"1548","Ohio",1998,205,127,10,342
"1549","Ohio",1997,217,14,120,351
"1550","Ohio",1996,200,10,106,316
"1551","Ohio",1995,174,1,109,284
"1552","Ohio",1994,140,1,83,224
"1553","Ohio",1993,140,1,87,228
"1554","Ohio",1992,137,3,87,227
"1555","Ohio",1991,110,2,57,169
"1556","Ohio",1990,116,2,76,194
"1557","Ohio",1989,91,0,63,154
"1558","Ohio",1988,89,2,69,160
"1559","Ohio",1987,92,3,77,172
"1560","Ohio",1986,75,2,79,156
"1561","Ohio",1985,28,0,81,109
"1562","Ohio",1984,58,4,86,148
"1563","Ohio",1983,60,3,95,158
"1564","Ohio",1982,54,6,87,147
"1565","Ohio",1981,43,2,98,143
"1566","Ohio",1980,41,5,92,138
"1567","Ohio",1979,36,4,103,143
"1568","Ohio",1978,41,2,107,150
"1569","Ohio",1977,50,1,111,162
"1570","Ohio",1976,45,3,118,166
"1571","Ohio",1975,51,5,132,188
"1572","Oklahoma",2017,17,13,0,30
"1573","Oklahoma",2016,18,7,0,25
"1574","Oklahoma",2015,17,5,0,22
"1575","Oklahoma",2014,12,8,1,21
"1576","Oklahoma",2013,15,4,1,20
"1577","Oklahoma",2012,12,9,1,22
"1578","Oklahoma",2011,9,12,1,22
"1579","Oklahoma",2010,12,9,1,22
"1580","Oklahoma",2009,12,9,1,22
"1581","Oklahoma",2008,10,9,0,19
"1582","Oklahoma",2007,17,6,0,23
"1583","Oklahoma",2006,23,10,1,34
"1584","Oklahoma",2005,22,10,1,33
"1585","Oklahoma",2004,28,6,2,36
"1586","Oklahoma",2003,20,29,0,49
"1587","Oklahoma",2002,19,30,0,49
"1588","Oklahoma",2001,21,35,0,56
"1589","Oklahoma",2000,17,35,0,52
"1590","Oklahoma",1999,20,34,0,54
"1591","Oklahoma",1998,17,34,0,51
"1592","Oklahoma",1997,15,0,29,44
"1593","Oklahoma",1996,18,0,24,42
"1594","Oklahoma",1995,15,0,13,28
"1595","Oklahoma",1994,14,0,9,23
"1596","Oklahoma",1993,13,0,12,25
"1597","Oklahoma",1992,15,0,15,30
"1598","Oklahoma",1991,10,0,13,23
"1599","Oklahoma",1990,8,0,12,20
"1600","Oklahoma",1989,9,1,9,19
"1601","Oklahoma",1988,10,0,13,23
"1602","Oklahoma",1987,7,0,12,19
"1603","Oklahoma",1986,4,0,14,18
"1604","Oklahoma",1985,4,0,15,19
"1605","Oklahoma",1984,4,0,13,17
"1606","Oklahoma",1983,2,0,8,10
"1607","Oklahoma",1982,6,0,9,15
"1608","Oklahoma",1981,3,0,12,15
"1609","Oklahoma",1980,3,0,9,12
"1610","Oklahoma",1979,3,0,15,18
"1611","Oklahoma",1978,2,1,11,14
"1612","Oklahoma",1977,4,0,13,17
"1613","Oklahoma",1976,2,0,15,17
"1614","Oklahoma",1975,5,1,12,18
"1615","Oregon",2017,17,41,0,58
"1616","Oregon",2016,16,21,1,38
"1617","Oregon",2015,19,17,3,39
"1618","Oregon",2014,19,12,5,36
"1619","Oregon",2013,19,17,3,39
"1620","Oregon",2012,16,12,4,32
"1621","Oregon",2011,12,19,4,35
"1622","Oregon",2010,12,19,2,33
"1623","Oregon",2009,12,19,2,33
"1624","Oregon",2008,7,15,1,23
"1625","Oregon",2007,5,16,1,22
"1626","Oregon",2006,15,14,1,30
"1627","Oregon",2005,15,11,0,26
"1628","Oregon",2004,17,10,1,28
"1629","Oregon",2003,19,27,2,48
"1630","Oregon",2002,14,26,1,41
"1631","Oregon",2001,19,23,1,43
"1632","Oregon",2000,16,28,1,45
"1633","Oregon",1999,13,26,0,39
"1634","Oregon",1998,13,29,0,42
"1635","Oregon",1997,12,0,30,42
"1636","Oregon",1996,12,0,33,45
"1637","Oregon",1995,11,1,28,40
"1638","Oregon",1994,6,1,16,23
"1639","Oregon",1993,9,0,9,18
"1640","Oregon",1992,8,0,9,17
"1641","Oregon",1991,6,0,12,18
"1642","Oregon",1990,8,0,12,20
"1643","Oregon",1989,3,1,11,15
"1644","Oregon",1988,3,0,11,14
"1645","Oregon",1987,4,0,8,12
"1646","Oregon",1986,1,0,9,10
"1647","Oregon",1985,1,0,14,15
"1648","Oregon",1984,2,0,10,12
"1649","Oregon",1983,2,0,14,16
"1650","Oregon",1982,1,1,8,10
"1651","Oregon",1981,2,2,8,12
"1652","Oregon",1980,4,0,8,12
"1653","Oregon",1979,2,0,7,9
"1654","Oregon",1978,2,1,8,11
"1655","Oregon",1977,0,1,17,18
"1656","Oregon",1976,1,0,17,18
"1657","Oregon",1975,3,0,18,21
"1658","Other US",2012,3,20,1,24
"1659","Other US",2011,8,19,1,28
"1660","Other US",2010,4,22,1,27
"1661","Other US",2009,4,22,1,27
"1662","Other US",2008,13,17,0,30
"1663","Other US",2007,11,17,0,28
"1664","Other US",2006,13,19,0,32
"1665","Other US",2005,10,19,0,29
"1666","Other US",2004,8,17,1,26
"1667","Other US",2003,7,31,2,40
"1668","Other US",2002,15,28,2,45
"1669","Other US",2001,17,27,3,47
"1670","Other US",2000,17,34,4,55
"1671","Other US",1999,17,21,2,40
"1672","Other US",1998,14,19,1,34
"1673","Pennsylvania",2017,68,83,14,165
"1674","Pennsylvania",2016,75,54,10,139
"1675","Pennsylvania",2015,78,62,9,149
"1676","Pennsylvania",2014,73,70,9,152
"1677","Pennsylvania",2013,62,74,8,144
"1678","Pennsylvania",2012,59,70,14,143
"1679","Pennsylvania",2011,56,69,21,146
"1680","Pennsylvania",2010,48,65,19,132
"1681","Pennsylvania",2009,48,65,19,132
"1682","Pennsylvania",2008,45,49,6,100
"1683","Pennsylvania",2007,32,38,8,78
"1684","Pennsylvania",2006,39,35,7,81
"1685","Pennsylvania",2005,55,42,5,102
"1686","Pennsylvania",2004,54,44,5,103
"1687","Pennsylvania",2003,62,109,8,179
"1688","Pennsylvania",2002,61,95,6,162
"1689","Pennsylvania",2001,57,91,7,155
"1690","Pennsylvania",2000,57,98,6,161
"1691","Pennsylvania",1999,60,85,7,152
"1692","Pennsylvania",1998,53,74,4,131
"1693","Pennsylvania",1997,58,6,78,142
"1694","Pennsylvania",1996,67,4,75,146
"1695","Pennsylvania",1995,66,0,77,143
"1696","Pennsylvania",1994,61,0,58,119
"1697","Pennsylvania",1993,61,2,75,138
"1698","Pennsylvania",1992,57,5,71,133
"1699","Pennsylvania",1991,65,5,76,146
"1700","Pennsylvania",1990,60,4,74,138
"1701","Pennsylvania",1989,43,2,56,101
"1702","Pennsylvania",1988,42,2,45,89
"1703","Pennsylvania",1987,28,2,42,72
"1704","Pennsylvania",1986,28,0,51,79
"1705","Pennsylvania",1985,20,0,60,80
"1706","Pennsylvania",1984,25,0,64,89
"1707","Pennsylvania",1983,31,0,66,97
"1708","Pennsylvania",1982,26,1,63,90
"1709","Pennsylvania",1981,19,5,68,92
"1710","Pennsylvania",1980,23,3,86,112
"1711","Pennsylvania",1979,20,4,86,110
"1712","Pennsylvania",1978,29,2,92,123
"1713","Pennsylvania",1977,29,4,81,114
"1714","Pennsylvania",1976,31,3,88,122
"1715","Pennsylvania",1975,36,2,107,145
"1716","Puerto Rico",2017,3,20,3,26
"1717","Puerto Rico",2016,6,19,1,26
"1718","Puerto Rico",2015,5,20,1,26
"1719","Puerto Rico",2014,6,17,1,24
"1720","Puerto Rico",2013,4,17,0,21
"1721","Rhode Island",2017,6,6,0,12
"1722","Rhode Island",2016,2,5,0,7
"1723","Rhode Island",2015,2,5,0,7
"1724","Rhode Island",2014,3,7,0,10
"1725","Rhode Island",2013,2,8,0,10
"1726","Rhode Island",2012,2,9,0,11
"1727","Rhode Island",2011,4,11,0,15
"1728","Rhode Island",2010,4,9,1,14
"1729","Rhode Island",2009,4,9,1,14
"1730","Rhode Island",2008,3,6,1,10
"1731","Rhode Island",2007,4,1,0,5
"1732","Rhode Island",2006,2,1,0,3
"1733","Rhode Island",2005,2,2,0,4
"1734","Rhode Island",2004,3,1,0,4
"1735","Rhode Island",2003,4,6,1,11
"1736","Rhode Island",2002,5,4,3,12
"1737","Rhode Island",2001,4,3,3,10
"1738","Rhode Island",2000,7,9,2,18
"1739","Rhode Island",1999,7,9,2,18
"1740","Rhode Island",1998,6,8,1,15
"1741","Rhode Island",1997,6,1,7,14
"1742","Rhode Island",1996,6,2,5,13
"1743","Rhode Island",1995,3,1,3,7
"1744","Rhode Island",1994,4,1,3,8
"1745","Rhode Island",1993,3,1,1,5
"1746","Rhode Island",1992,4,1,2,7
"1747","Rhode Island",1991,6,1,5,12
"1748","Rhode Island",1990,3,0,5,8
"1749","Rhode Island",1989,2,0,2,4
"1750","Rhode Island",1988,0,0,4,4
"1751","Rhode Island",1987,1,0,3,4
"1752","Rhode Island",1986,2,0,2,4
"1753","Rhode Island",1985,3,0,5,8
"1754","Rhode Island",1984,3,0,4,7
"1755","Rhode Island",1983,1,0,NA,1
"1756","Rhode Island",1982,0,0,3,3
"1757","Rhode Island",1981,2,0,4,6
"1758","Rhode Island",1980,6,0,8,14
"1759","Rhode Island",1979,5,0,6,11
"1760","Rhode Island",1978,3,0,5,8
"1761","Rhode Island",1977,2,0,5,7
"1762","Rhode Island",1976,1,0,7,8
"1763","Rhode Island",1975,1,0,7,8
"1764","South Carolina",2017,7,17,2,26
"1765","South Carolina",2016,5,15,2,22
"1766","South Carolina",2015,5,16,4,25
"1767","South Carolina",2014,8,16,1,25
"1768","South Carolina",2013,8,14,2,24
"1769","South Carolina",2012,5,10,1,16
"1770","South Carolina",2011,3,13,2,18
"1771","South Carolina",2010,7,8,2,17
"1772","South Carolina",2009,7,8,2,17
"1773","South Carolina",2008,12,15,1,28
"1774","South Carolina",2007,9,17,1,27
"1775","South Carolina",2006,7,13,0,20
"1776","South Carolina",2005,10,14,0,24
"1777","South Carolina",2004,10,3,0,13
"1778","South Carolina",2003,10,12,1,23
"1779","South Carolina",2002,9,10,1,20
"1780","South Carolina",2001,9,10,2,21
"1781","South Carolina",2000,7,14,2,23
"1782","South Carolina",1999,12,12,3,27
"1783","South Carolina",1998,12,15,2,29
"1784","South Carolina",1997,17,2,16,35
"1785","South Carolina",1996,15,0,15,30
"1786","South Carolina",1995,7,0,1,8
"1787","South Carolina",1994,9,0,11,20
"1788","South Carolina",1993,9,0,11,20
"1789","South Carolina",1992,12,0,7,19
"1790","South Carolina",1991,5,0,12,17
"1791","South Carolina",1990,8,0,14,22
"1792","South Carolina",1989,7,2,10,19
"1793","South Carolina",1988,5,1,6,12
"1794","South Carolina",1987,3,1,10,14
"1795","South Carolina",1986,3,0,14,17
"1796","South Carolina",1985,5,0,9,14
"1797","South Carolina",1984,0,0,6,6
"1798","South Carolina",1983,1,0,5,6
"1799","South Carolina",1982,1,0,8,9
"1800","South Carolina",1981,0,0,13,13
"1801","South Carolina",1980,1,0,11,12
"1802","South Carolina",1979,1,0,12,13
"1803","South Carolina",1978,4,0,6,10
"1804","South Carolina",1977,2,1,8,11
"1805","South Carolina",1976,2,0,13,15
"1806","South Carolina",1975,3,1,18,22
"1807","South Dakota",2017,3,4,1,8
"1808","South Dakota",2016,2,4,0,6
"1809","South Dakota",2015,3,8,0,11
"1810","South Dakota",2014,6,7,0,13
"1811","South Dakota",2013,5,7,1,13
"1812","South Dakota",2012,5,6,1,12
"1813","South Dakota",2011,5,3,2,10
"1814","South Dakota",2010,1,2,1,4
"1815","South Dakota",2009,1,2,1,4
"1816","South Dakota",2008,1,4,0,5
"1817","South Dakota",2007,1,6,0,7
"1818","South Dakota",2006,3,3,0,6
"1819","South Dakota",2005,4,2,0,6
"1820","South Dakota",2004,5,0,0,5
"1821","South Dakota",2003,5,3,0,8
"1822","South Dakota",2002,4,4,0,8
"1823","South Dakota",2001,5,5,1,11
"1824","South Dakota",2000,5,4,2,11
"1825","South Dakota",1999,6,6,2,14
"1826","South Dakota",1998,5,6,2,13
"1827","South Dakota",1997,5,1,7,13
"1828","South Dakota",1996,2,0,6,8
"1829","South Dakota",1995,1,0,6,7
"1830","South Dakota",1994,0,0,6,6
"1831","South Dakota",1993,0,0,5,5
"1832","South Dakota",1992,0,0,3,3
"1833","South Dakota",1991,1,0,2,3
"1834","South Dakota",1990,3,1,2,6
"1835","South Dakota",1989,1,0,5,6
"1836","South Dakota",1988,1,0,4,5
"1837","South Dakota",1987,2,0,5,7
"1838","South Dakota",1986,1,0,5,6
"1839","South Dakota",1985,1,0,7,8
"1840","South Dakota",1984,1,0,10,11
"1841","South Dakota",1983,2,0,7,9
"1842","South Dakota",1982,0,1,8,9
"1843","South Dakota",1981,0,1,5,6
"1844","South Dakota",1980,1,1,11,13
"1845","South Dakota",1979,2,1,4,7
"1846","South Dakota",1978,0,0,3,3
"1847","South Dakota",1977,0,0,5,5
"1848","South Dakota",1976,1,0,2,3
"1849","South Dakota",1975,1,0,3,4
"1850","Tennessee",2017,45,53,4,102
"1851","Tennessee",2016,46,36,2,84
"1852","Tennessee",2015,43,27,4,74
"1853","Tennessee",2014,42,25,4,71
"1854","Tennessee",2013,39,27,3,69
"1855","Tennessee",2012,37,30,3,70
"1856","Tennessee",2011,35,28,2,65
"1857","Tennessee",2010,25,29,2,56
"1858","Tennessee",2009,25,29,2,56
"1859","Tennessee",2008,28,36,1,65
"1860","Tennessee",2007,25,22,3,50
"1861","Tennessee",2006,28,21,3,52
"1862","Tennessee",2005,38,17,3,58
"1863","Tennessee",2004,41,9,2,52
"1864","Tennessee",2003,43,42,1,86
"1865","Tennessee",2002,44,47,1,92
"1866","Tennessee",2001,41,39,1,81
"1867","Tennessee",2000,35,37,2,74
"1868","Tennessee",1999,43,37,2,82
"1869","Tennessee",1998,52,46,1,99
"1870","Tennessee",1997,52,2,41,95
"1871","Tennessee",1996,51,1,40,92
"1872","Tennessee",1995,44,1,31,76
"1873","Tennessee",1994,37,1,19,57
"1874","Tennessee",1993,33,2,25,60
"1875","Tennessee",1992,38,1,19,58
"1876","Tennessee",1991,43,2,25,70
"1877","Tennessee",1990,39,2,28,69
"1878","Tennessee",1989,36,1,27,64
"1879","Tennessee",1988,26,0,35,61
"1880","Tennessee",1987,24,0,30,54
"1881","Tennessee",1986,22,1,27,50
"1882","Tennessee",1985,16,0,20,36
"1883","Tennessee",1984,18,0,20,38
"1884","Tennessee",1983,13,0,18,31
"1885","Tennessee",1982,13,0,17,30
"1886","Tennessee",1981,17,1,23,41
"1887","Tennessee",1980,21,0,23,44
"1888","Tennessee",1979,16,0,21,37
"1889","Tennessee",1978,10,0,21,31
"1890","Tennessee",1977,9,0,22,31
"1891","Tennessee",1976,4,1,23,28
"1892","Tennessee",1975,8,1,33,42
"1893","Texas",2017,162,188,18,368
"1894","Texas",2016,164,92,16,272
"1895","Texas",2015,148,81,13,242
"1896","Texas",2014,119,85,17,221
"1897","Texas",2013,121,84,17,222
"1898","Texas",2012,109,89,19,217
"1899","Texas",2011,100,89,25,214
"1900","Texas",2010,87,76,25,188
"1901","Texas",2009,87,76,25,188
"1902","Texas",2008,102,66,14,182
"1903","Texas",2007,92,70,10,172
"1904","Texas",2006,85,71,13,169
"1905","Texas",2005,87,48,12,147
"1906","Texas",2004,93,41,7,141
"1907","Texas",2003,85,136,5,226
"1908","Texas",2002,72,126,4,202
"1909","Texas",2001,55,103,6,164
"1910","Texas",2000,47,98,6,151
"1911","Texas",1999,57,87,7,151
"1912","Texas",1998,53,100,5,158
"1913","Texas",1997,44,7,100,151
"1914","Texas",1996,45,5,92,142
"1915","Texas",1995,44,2,63,109
"1916","Texas",1994,37,2,56,95
"1917","Texas",1993,48,2,54,104
"1918","Texas",1992,44,0,55,99
"1919","Texas",1991,49,0,47,96
"1920","Texas",1990,44,0,45,89
"1921","Texas",1989,33,0,38,71
"1922","Texas",1988,27,0,37,64
"1923","Texas",1987,22,0,36,58
"1924","Texas",1986,12,0,31,43
"1925","Texas",1985,12,0,31,43
"1926","Texas",1984,10,0,33,43
"1927","Texas",1983,10,1,47,58
"1928","Texas",1982,12,1,52,65
"1929","Texas",1981,13,1,47,61
"1930","Texas",1980,16,1,40,57
"1931","Texas",1979,15,0,36,51
"1932","Texas",1978,11,1,46,58
"1933","Texas",1977,9,1,45,55
"1934","Texas",1976,11,0,37,48
"1935","Texas",1975,11,1,42,54
"1936","Unknown",2017,282,1435,59,1776
"1937","Unknown",2016,525,1146,65,1736
"1938","Unknown",2015,548,1177,48,1773
"1939","Unknown",2014,596,1214,52,1862
"1940","Unknown",2013,574,1253,52,1879
"1941","Unknown",2012,606,1269,72,1947
"1942","Unknown",2011,624,1325,84,2033
"1943","Unknown",2010,612,1432,79,2123
"1944","Unknown",2009,612,1432,79,2123
"1945","Unknown",2008,568,1546,103,2217
"1946","Unknown",2007,486,1581,113,2180
"1947","Unknown",2006,498,1659,132,2289
"1948","Unknown",2005,508,1804,141,2453
"1949","Unknown",2004,473,1851,82,2406
"1950","Utah",2017,7,21,0,28
"1951","Utah",2016,7,14,0,21
"1952","Utah",2015,8,15,0,23
"1953","Utah",2014,6,16,0,22
"1954","Utah",2013,3,19,0,22
"1955","Utah",2012,4,16,0,20
"1956","Utah",2011,4,10,1,15
"1957","Utah",2010,2,11,5,18
"1958","Utah",2009,2,11,5,18
"1959","Utah",2008,4,19,5,28
"1960","Utah",2007,4,21,1,26
"1961","Utah",2006,4,20,2,26
"1962","Utah",2005,7,17,2,26
"1963","Utah",2004,11,13,3,27
"1964","Utah",2003,6,52,4,62
"1965","Utah",2002,7,44,2,53
"1966","Utah",2001,8,43,3,54
"1967","Utah",2000,4,45,2,51
"1968","Utah",1999,6,41,3,50
"1969","Utah",1998,3,39,3,45
"1970","Utah",1997,6,2,26,34
"1971","Utah",1996,5,0,19,24
"1972","Utah",1995,2,1,11,14
"1973","Utah",1994,1,1,2,4
"1974","Utah",1993,1,1,2,4
"1975","Utah",1992,2,1,6,9
"1976","Utah",1991,1,1,4,6
"1977","Utah",1990,1,0,5,6
"1978","Utah",1989,1,0,9,10
"1979","Utah",1988,0,0,3,3
"1980","Utah",1987,0,0,8,8
"1981","Utah",1986,1,0,5,6
"1982","Utah",1985,1,0,9,10
"1983","Utah",1984,0,0,12,12
"1984","Utah",1983,0,0,9,9
"1985","Utah",1982,0,1,7,8
"1986","Utah",1981,0,0,13,13
"1987","Utah",1980,0,0,11,11
"1988","Utah",1979,2,0,11,13
"1989","Utah",1978,0,0,10,10
"1990","Utah",1977,0,0,8,8
"1991","Utah",1976,0,0,9,9
"1992","Utah",1975,0,0,5,5
"1993","Vermont",2017,1,6,0,7
"1994","Vermont",2016,2,3,0,5
"1995","Vermont",2015,3,4,0,7
"1996","Vermont",2014,1,4,0,5
"1997","Vermont",2013,1,3,0,4
"1998","Vermont",2012,1,2,1,4
"1999","Vermont",2011,2,2,0,4
"2000","Vermont",2010,1,0,1,2
"2001","Vermont",2009,1,0,1,2
"2002","Vermont",2008,6,1,2,9
"2003","Vermont",2007,7,0,1,8
"2004","Vermont",2006,8,1,2,11
"2005","Vermont",2005,6,1,0,7
"2006","Vermont",2004,3,2,0,5
"2007","Vermont",2003,2,7,0,9
"2008","Vermont",2002,1,5,0,6
"2009","Vermont",2001,1,6,0,7
"2010","Vermont",2000,2,6,0,8
"2011","Vermont",1999,4,8,0,12
"2012","Vermont",1998,3,5,0,8
"2013","Vermont",1997,4,0,6,10
"2014","Vermont",1996,5,0,9,14
"2015","Vermont",1995,1,0,8,9
"2016","Vermont",1994,1,0,6,7
"2017","Vermont",1993,0,0,4,4
"2018","Vermont",1992,2,0,2,4
"2019","Vermont",1991,3,0,3,6
"2020","Vermont",1990,2,0,2,4
"2021","Vermont",1989,3,1,1,5
"2022","Vermont",1988,2,1,1,4
"2023","Vermont",1987,1,1,4,6
"2024","Vermont",1986,2,0,6,8
"2025","Vermont",1985,0,0,5,5
"2026","Vermont",1984,0,0,4,4
"2027","Vermont",1983,0,0,8,8
"2028","Vermont",1982,0,0,3,3
"2029","Vermont",1981,0,0,3,3
"2030","Vermont",1980,0,0,4,4
"2031","Vermont",1979,4,0,4,8
"2032","Vermont",1978,8,0,8,16
"2033","Vermont",1977,1,0,8,9
"2034","Vermont",1976,0,0,4,4
"2035","Vermont",1975,0,0,1,1
"2036","Virgin Islands",2017,0,1,0,1
"2037","Virginia",2017,133,77,7,217
"2038","Virginia",2016,133,41,8,182
"2039","Virginia",2015,128,42,4,174
"2040","Virginia",2014,123,39,3,165
"2041","Virginia",2013,112,43,4,159
"2042","Virginia",2012,81,48,5,134
"2043","Virginia",2011,61,40,5,106
"2044","Virginia",2010,56,36,2,94
"2045","Virginia",2009,56,36,2,94
"2046","Virginia",2008,67,36,4,107
"2047","Virginia",2007,68,29,4,101
"2048","Virginia",2006,69,24,1,94
"2049","Virginia",2005,74,33,0,107
"2050","Virginia",2004,58,33,2,93
"2051","Virginia",2003,74,78,9,161
"2052","Virginia",2002,77,74,8,159
"2053","Virginia",2001,86,73,8,167
"2054","Virginia",2000,91,69,4,164
"2055","Virginia",1999,89,60,2,151
"2056","Virginia",1998,101,56,7,164
"2057","Virginia",1997,90,4,60,154
"2058","Virginia",1996,82,5,63,150
"2059","Virginia",1995,75,2,58,135
"2060","Virginia",1994,48,2,41,91
"2061","Virginia",1993,42,1,41,84
"2062","Virginia",1992,44,4,31,79
"2063","Virginia",1991,36,1,34,71
"2064","Virginia",1990,42,0,25,67
"2065","Virginia",1989,24,0,27,51
"2066","Virginia",1988,24,0,30,54
"2067","Virginia",1987,21,0,32,53
"2068","Virginia",1986,16,0,42,58
"2069","Virginia",1985,17,1,36,54
"2070","Virginia",1984,18,1,39,58
"2071","Virginia",1983,13,2,27,42
"2072","Virginia",1982,14,1,33,48
"2073","Virginia",1981,12,0,34,46
"2074","Virginia",1980,16,0,36,52
"2075","Virginia",1979,28,0,28,56
"2076","Virginia",1978,33,0,33,66
"2077","Virginia",1977,20,0,32,52
"2078","Virginia",1976,15,0,39,54
"2079","Virginia",1975,15,0,41,56
"2080","Washington",2017,60,82,2,144
"2081","Washington",2016,67,38,4,109
"2082","Washington",2015,61,34,5,100
"2083","Washington",2014,63,35,5,103
"2084","Washington",2013,43,34,8,85
"2085","Washington",2012,31,40,8,79
"2086","Washington",2011,26,31,7,64
"2087","Washington",2010,22,33,4,59
"2088","Washington",2009,22,33,4,59
"2089","Washington",2008,23,30,6,59
"2090","Washington",2007,29,33,4,66
"2091","Washington",2006,32,25,1,58
"2092","Washington",2005,25,19,1,45
"2093","Washington",2004,32,10,1,43
"2094","Washington",2003,29,54,2,85
"2095","Washington",2002,22,54,1,77
"2096","Washington",2001,23,48,2,73
"2097","Washington",2000,13,39,3,55
"2098","Washington",1999,11,33,4,48
"2099","Washington",1998,8,36,4,48
"2100","Washington",1997,7,5,40,52
"2101","Washington",1996,14,3,32,49
"2102","Washington",1995,14,0,25,39
"2103","Washington",1994,11,0,12,23
"2104","Washington",1993,8,0,15,23
"2105","Washington",1992,9,0,20,29
"2106","Washington",1991,9,1,14,24
"2107","Washington",1990,9,0,17,26
"2108","Washington",1989,6,1,20,27
"2109","Washington",1988,10,1,22,33
"2110","Washington",1987,3,1,19,23
"2111","Washington",1986,3,1,30,34
"2112","Washington",1985,1,0,21,22
"2113","Washington",1984,3,0,22,25
"2114","Washington",1983,4,0,13,17
"2115","Washington",1982,1,1,17,19
"2116","Washington",1981,0,1,19,20
"2117","Washington",1980,3,1,20,24
"2118","Washington",1979,18,0,18,36
"2119","Washington",1978,28,0,28,56
"2120","Washington",1977,3,0,24,27
"2121","Washington",1976,5,0,14,19
"2122","Washington",1975,3,0,24,27
"2123","West Virginia",2017,1,12,3,16
"2124","West Virginia",2016,0,8,3,11
"2125","West Virginia",2015,4,5,0,9
"2126","West Virginia",2014,4,6,0,10
"2127","West Virginia",2013,5,6,0,11
"2128","West Virginia",2012,7,8,0,15
"2129","West Virginia",2011,4,7,1,12
"2130","West Virginia",2010,4,5,1,10
"2131","West Virginia",2009,4,5,1,10
"2132","West Virginia",2008,5,5,0,10
"2133","West Virginia",2007,5,5,0,10
"2134","West Virginia",2006,5,3,0,8
"2135","West Virginia",2005,5,5,1,11
"2136","West Virginia",2004,6,3,0,9
"2137","West Virginia",2003,5,9,0,14
"2138","West Virginia",2002,6,9,1,16
"2139","West Virginia",2001,5,9,1,15
"2140","West Virginia",2000,5,8,1,14
"2141","West Virginia",1999,7,7,0,14
"2142","West Virginia",1998,7,9,0,16
"2143","West Virginia",1997,9,0,11,20
"2144","West Virginia",1996,9,0,14,23
"2145","West Virginia",1995,5,0,6,11
"2146","West Virginia",1994,3,0,3,6
"2147","West Virginia",1993,3,0,5,8
"2148","West Virginia",1992,6,0,7,13
"2149","West Virginia",1991,6,0,3,9
"2150","West Virginia",1990,8,0,3,11
"2151","West Virginia",1989,8,0,2,10
"2152","West Virginia",1988,3,0,1,4
"2153","West Virginia",1987,4,0,4,8
"2154","West Virginia",1986,3,0,5,8
"2155","West Virginia",1985,3,0,4,7
"2156","West Virginia",1984,2,0,3,5
"2157","West Virginia",1983,0,0,7,7
"2158","West Virginia",1982,2,0,7,9
"2159","West Virginia",1981,1,0,8,9
"2160","West Virginia",1980,2,0,6,8
"2161","West Virginia",1979,5,0,5,10
"2162","West Virginia",1978,1,0,1,2
"2163","West Virginia",1977,3,0,4,7
"2164","West Virginia",1976,3,0,5,8
"2165","West Virginia",1975,2,0,10,12
"2166","Wisconsin",2017,66,87,17,170
"2167","Wisconsin",2016,60,65,14,139
"2168","Wisconsin",2015,61,64,14,139
"2169","Wisconsin",2014,65,71,15,151
"2170","Wisconsin",2013,60,68,16,144
"2171","Wisconsin",2012,69,77,13,159
"2172","Wisconsin",2011,67,75,13,155
"2173","Wisconsin",2010,50,77,7,134
"2174","Wisconsin",2009,50,77,7,134
"2175","Wisconsin",2008,48,51,4,103
"2176","Wisconsin",2007,56,47,4,107
"2177","Wisconsin",2006,61,49,3,113
"2178","Wisconsin",2005,54,41,3,98
"2179","Wisconsin",2004,54,34,4,92
"2180","Wisconsin",2003,59,97,7,163
"2181","Wisconsin",2002,66,93,9,168
"2182","Wisconsin",2001,63,83,13,159
"2183","Wisconsin",2000,63,80,10,153
"2184","Wisconsin",1999,70,91,5,166
"2185","Wisconsin",1998,72,84,5,161
"2186","Wisconsin",1997,73,5,81,159
"2187","Wisconsin",1996,84,6,79,169
"2188","Wisconsin",1995,74,5,75,154
"2189","Wisconsin",1994,66,5,56,127
"2190","Wisconsin",1993,58,3,55,116
"2191","Wisconsin",1992,66,2,54,122
"2192","Wisconsin",1991,53,1,53,107
"2193","Wisconsin",1990,45,1,50,96
"2194","Wisconsin",1989,44,0,40,84
"2195","Wisconsin",1988,35,2,32,69
"2196","Wisconsin",1987,40,0,51,91
"2197","Wisconsin",1986,47,0,47,94
"2198","Wisconsin",1985,43,0,66,109
"2199","Wisconsin",1984,38,0,78,116
"2200","Wisconsin",1983,33,2,73,108
"2201","Wisconsin",1982,36,3,76,115
"2202","Wisconsin",1981,43,3,52,98
"2203","Wisconsin",1980,39,4,63,106
"2204","Wisconsin",1979,51,6,51,108
"2205","Wisconsin",1978,56,5,56,117
"2206","Wisconsin",1977,29,1,64,94
"2207","Wisconsin",1976,30,2,64,96
"2208","Wisconsin",1975,30,3,73,106
"2209","Wyoming",2017,3,5,0,8
"2210","Wyoming",2016,1,3,0,4
"2211","Wyoming",2015,1,2,0,3
"2212","Wyoming",2014,1,1,0,2
"2213","Wyoming",2013,0,2,1,3
"2214","Wyoming",2012,1,0,1,2
"2215","Wyoming",2011,1,0,1,2
"2216","Wyoming",2010,2,0,0,2
"2217","Wyoming",2009,2,0,0,2
"2218","Wyoming",2008,1,0,0,1
"2219","Wyoming",2007,1,0,0,1
"2220","Wyoming",2006,1,0,0,1
"2221","Wyoming",2005,2,1,0,3
"2222","Wyoming",2004,3,2,0,5
"2223","Wyoming",2003,1,6,1,8
"2224","Wyoming",2002,0,4,1,5
"2225","Wyoming",2001,0,6,1,7
"2226","Wyoming",2000,1,5,0,6
"2227","Wyoming",1999,1,5,1,7
"2228","Wyoming",1998,0,5,1,6
"2229","Wyoming",1997,0,1,4,5
"2230","Wyoming",1996,1,0,1,2
"2231","Wyoming",1995,2,0,2,4
"2232","Wyoming",1994,1,0,2,3
"2233","Wyoming",1993,0,0,1,1
"2234","Wyoming",1992,2,0,1,3
"2235","Wyoming",1991,1,0,3,4
"2236","Wyoming",1990,1,0,4,5
"2237","Wyoming",1989,1,0,5,6
"2238","Wyoming",1988,1,1,4,6
"2239","Wyoming",1987,0,0,3,3
"2240","Wyoming",1986,2,0,2,4
"2241","Wyoming",1985,1,0,5,6
"2242","Wyoming",1984,1,0,2,3
"2243","Wyoming",1983,0,0,2,2
"2244","Wyoming",1982,0,0,0,0
"2245","Wyoming",1981,0,0,1,1
"2246","Wyoming",1980,1,0,2,3
"2247","Wyoming",1979,4,0,4,8
"2248","Wyoming",1978,5,0,5,10
"2249","Wyoming",1977,1,0,4,5
"2250","Wyoming",1976,1,0,0,1
"2251","Wyoming",1975,0,0,1,1
